id,final_grade,math_camp,math_camp_num,undergrad_gpa,gre_quant,gre_verbal,gre_total
1,142,No math camp,0,3.9,151,170,321
2,135,No math camp,0,3.2,143,163,306
3,140,Math camp,1,2.83,140,162,302
4,138,No math camp,0,2.63,154,144,298
5,143,No math camp,0,3.24,148,170,318
6,144,No math camp,0,2.95,146,167,313
7,162,Math camp,1,3.76,151,170,321
8,133,No math camp,0,3.37,144,159,303
9,156,Math camp,1,3.09,149,162,311
10,136,No math camp,0,3.89,153,170,323
11,135,No math camp,0,3.31,149,167,316
12,153,Math camp,1,3.3,153,167,320
13,141,No math camp,0,2.9,148,155,303
14,136,No math camp,0,3.4,141,160,301
15,146,Math camp,1,3.81,141,170,311
16,129,No math camp,0,2.2,145,146,291
17,143,No math camp,0,3.3,145,159,304
18,135,No math camp,0,3.43,147,161,308
19,143,No math camp,0,3.44,147,161,308
20,138,Math camp,1,2.44,133,158,291
21,143,No math camp,0,2.83,141,153,294
22,136,No math camp,0,3.49,148,167,315
23,135,No math camp,0,3.38,146,162,308
24,137,Math camp,1,1.55,138,130,268
25,148,Math camp,1,3.26,152,168,320
26,136,No math camp,0,3.07,151,155,306
27,154,Math camp,1,3.5,145,170,315
28,143,No math camp,0,3.32,148,159,307
29,145,Math camp,1,2.82,142,152,294
30,147,No math camp,0,4,155,170,325
31,136,No math camp,0,3.07,141,167,308
32,135,Math camp,1,1.97,143,135,278
33,142,No math camp,0,3.73,149,170,319
34,137,Math camp,1,3.54,151,170,321
35,141,No math camp,0,3.04,152,154,306
36,143,No math camp,0,3.53,152,167,319
37,127,No math camp,0,2.33,154,139,293
38,139,No math camp,0,3.02,148,150,298
39,136,No math camp,0,3.22,143,156,299
40,140,No math camp,0,3.82,149,170,319
41,135,No math camp,0,2.24,139,154,293
42,141,No math camp,0,2.75,150,153,303
43,151,No math camp,0,4,153,170,323
44,136,No math camp,0,3.3,143,158,301
45,134,No math camp,0,2.75,150,153,303
46,145,No math camp,0,3.58,152,170,322
47,142,No math camp,0,3.36,150,162,312
48,141,Math camp,1,2.92,144,143,287
49,131,No math camp,0,2.88,145,153,298
50,142,No math camp,0,3.42,151,170,321
51,144,No math camp,0,3.09,154,156,310
52,137,No math camp,0,2.5,144,143,287
53,138,No math camp,0,3.18,150,159,309
54,139,No math camp,0,3.04,152,161,313
55,138,Math camp,1,2.85,142,151,293
56,139,No math camp,0,3.22,143,166,309
57,139,No math camp,0,2.83,138,164,302
58,132,No math camp,0,2.87,146,152,298
59,141,Math camp,1,1.96,134,142,276
60,139,No math camp,0,3.53,152,168,320
61,141,Math camp,1,2.48,145,158,303
62,141,Math camp,1,2.4,134,161,295
63,145,Math camp,1,2.59,144,150,294
64,150,Math camp,1,2.56,145,144,289
65,147,Math camp,1,2.45,141,144,285
66,142,Math camp,1,2.45,139,160,299
67,139,No math camp,0,2.97,148,151,299
68,150,Math camp,1,2.45,143,164,307
69,136,No math camp,0,3.05,140,167,307
70,141,No math camp,0,3.14,147,170,317
71,138,No math camp,0,3.06,149,168,317
72,142,Math camp,1,3.09,145,156,301
73,131,No math camp,0,3,144,154,298
74,136,No math camp,0,2.57,143,156,299
75,149,Math camp,1,2.78,138,168,306
76,152,Math camp,1,3.16,144,159,303
77,151,No math camp,0,3.37,155,168,323
78,144,No math camp,0,4,151,170,321
79,143,No math camp,0,3.2,145,166,311
80,141,No math camp,0,3.15,148,163,311
81,143,No math camp,0,3.96,146,170,316
82,155,Math camp,1,3.5,151,170,321
83,139,No math camp,0,3.29,153,162,315
84,132,Math camp,1,2.72,145,154,299
85,151,Math camp,1,2.77,139,155,294
86,146,Math camp,1,1.98,140,142,282
87,151,Math camp,1,2.69,143,158,301
88,140,Math camp,1,2.17,142,137,279
89,139,No math camp,0,2.44,147,151,298
90,134,No math camp,0,3.4,150,162,312
91,149,Math camp,1,3.16,152,170,322
92,116,No math camp,0,2.22,138,138,276
93,132,Math camp,1,1.85,135,144,279
94,146,Math camp,1,2.41,140,153,293
95,125,No math camp,0,2.78,144,150,294
96,149,Math camp,1,2.7,140,151,291
97,140,No math camp,0,3.07,147,153,300
98,127,No math camp,0,2.76,138,154,292
99,139,Math camp,1,2.34,139,149,288
100,136,Math camp,1,2.59,138,166,304
101,155,Math camp,1,2.41,146,157,303
102,139,No math camp,0,3.3,146,161,307
103,143,No math camp,0,3.29,147,168,315
104,139,Math camp,1,2.68,141,142,283
105,146,No math camp,0,3.85,151,170,321
106,148,Math camp,1,3.14,143,161,304
107,146,No math camp,0,3.57,150,168,318
108,144,No math camp,0,2.31,147,153,300
109,148,Math camp,1,2.57,144,156,300
110,129,No math camp,0,2.8,146,158,304
111,148,No math camp,0,4,152,170,322
112,142,No math camp,0,3.45,156,170,326
113,128,No math camp,0,2.46,150,148,298
114,158,Math camp,1,3.33,143,170,313
115,147,Math camp,1,2.91,145,159,304
116,149,Math camp,1,2.46,140,152,292
117,146,No math camp,0,3.97,148,167,315
118,134,No math camp,0,2.95,147,165,312
119,151,Math camp,1,3.15,142,165,307
120,135,Math camp,1,2.24,142,142,284
121,142,Math camp,1,2.39,143,144,287
122,139,Math camp,1,2.43,144,140,284
123,134,Math camp,1,1.81,133,144,277
124,157,Math camp,1,3.12,147,170,317
125,140,No math camp,0,3.07,142,170,312
126,127,No math camp,0,3.21,143,162,305
127,153,Math camp,1,3.47,147,164,311
128,158,Math camp,1,4,154,170,324
129,142,No math camp,0,3.9,152,170,322
130,143,Math camp,1,2.48,141,148,289
131,135,Math camp,1,2.35,136,146,282
132,150,Math camp,1,2.61,144,155,299
133,132,No math camp,0,3.28,149,159,308
134,134,No math camp,0,3.41,140,166,306
135,137,No math camp,0,3.03,155,160,315
136,143,No math camp,0,3.17,151,170,321
137,137,No math camp,0,2.63,149,157,306
138,167,Math camp,1,3.55,157,167,324
139,125,No math camp,0,3.22,139,163,302
140,134,No math camp,0,2.94,146,153,299
141,134,No math camp,0,3.02,148,161,309
142,132,Math camp,1,2.04,136,145,281
143,145,Math camp,1,2.08,139,142,281
144,138,Math camp,1,2.46,143,147,290
145,143,Math camp,1,3.88,144,170,314
146,144,No math camp,0,3.43,147,170,317
147,142,Math camp,1,2.66,137,160,297
148,133,No math camp,0,2.85,144,158,302
149,134,No math camp,0,3.08,139,158,297
150,141,No math camp,0,3.46,147,170,317
151,139,No math camp,0,3,148,161,309
152,135,No math camp,0,3.05,143,159,302
153,134,No math camp,0,3.33,141,170,311
154,139,No math camp,0,3.04,149,157,306
155,145,Math camp,1,2.07,141,139,280
156,138,No math camp,0,3.45,142,170,312
157,142,Math camp,1,2.28,144,144,288
158,135,No math camp,0,2.92,147,150,297
159,137,No math camp,0,2.38,148,145,293
160,129,No math camp,0,1.99,146,140,286
161,132,No math camp,0,2.86,150,157,307
162,140,No math camp,0,2.95,146,158,304
163,144,No math camp,0,3.32,150,169,319
164,140,No math camp,0,3.2,143,158,301
165,144,Math camp,1,2.13,142,145,287
166,138,Math camp,1,2.27,144,153,297
167,133,No math camp,0,2.27,135,149,284
168,137,Math camp,1,2.56,143,148,291
169,150,Math camp,1,3.64,149,170,319
170,151,Math camp,1,2.78,137,159,296
171,135,No math camp,0,2.37,140,161,301
172,127,No math camp,0,3.45,144,165,309
173,134,No math camp,0,2.82,148,159,307
174,143,No math camp,0,4,154,170,324
175,136,Math camp,1,2.41,136,152,288
176,160,Math camp,1,3.63,150,170,320
177,149,Math camp,1,3.31,148,157,305
178,145,Math camp,1,2.78,137,170,307
179,132,No math camp,0,3.14,145,164,309
180,133,No math camp,0,2.81,147,160,307
181,147,No math camp,0,3.64,159,164,323
182,133,No math camp,0,2.59,148,157,305
183,140,Math camp,1,2.08,140,147,287
184,146,Math camp,1,2.78,142,155,297
185,141,No math camp,0,2.49,145,162,307
186,133,No math camp,0,3.04,135,166,301
187,130,No math camp,0,2.5,141,159,300
188,147,No math camp,0,3.35,148,165,313
189,139,No math camp,0,3.29,141,165,306
190,138,No math camp,0,2.86,148,160,308
191,142,Math camp,1,2.26,143,138,281
192,133,No math camp,0,3.6,156,157,313
193,139,No math camp,0,2.99,147,155,302
194,134,No math camp,0,3.17,144,167,311
195,140,Math camp,1,2.48,135,159,294
196,143,Math camp,1,2.84,142,158,300
197,135,No math camp,0,3.03,140,159,299
198,140,No math camp,0,3.12,149,158,307
199,129,No math camp,0,2.44,139,142,281
200,139,No math camp,0,3.96,159,170,329
201,146,Math camp,1,2.92,141,157,298
202,145,Math camp,1,2.91,140,157,297
203,145,No math camp,0,2.92,147,164,311
204,135,No math camp,0,3.48,139,166,305
205,141,No math camp,0,3.3,146,170,316
206,152,Math camp,1,2.85,144,165,309
207,134,No math camp,0,3.62,141,170,311
208,130,Math camp,1,2.3,137,148,285
209,144,No math camp,0,3.04,147,164,311
210,133,No math camp,0,3.53,146,159,305
211,156,Math camp,1,3.39,142,166,308
212,135,No math camp,0,3.04,139,146,285
213,138,Math camp,1,2.53,138,157,295
214,136,No math camp,0,2.79,146,140,286
215,150,Math camp,1,2.82,147,156,303
216,136,No math camp,0,3.02,137,152,289
217,135,No math camp,0,2.85,146,158,304
218,153,Math camp,1,3.04,147,157,304
219,152,Math camp,1,3.08,147,162,309
220,139,No math camp,0,2.44,144,156,300
221,138,Math camp,1,2.35,140,151,291
222,139,Math camp,1,2.51,142,154,296
223,151,Math camp,1,2.98,139,170,309
224,126,Math camp,1,1.96,139,145,284
225,148,No math camp,0,3.05,146,166,312
226,138,Math camp,1,2.86,146,151,297
227,146,Math camp,1,2.14,134,159,293
228,144,No math camp,0,3.1,141,162,303
229,135,No math camp,0,2.75,148,153,301
230,143,No math camp,0,3.42,146,170,316
231,149,Math camp,1,3.16,146,161,307
232,137,No math camp,0,3.35,148,167,315
233,137,No math camp,0,3.07,147,154,301
234,131,No math camp,0,3.56,141,164,305
235,158,Math camp,1,3.49,147,170,317
236,138,No math camp,0,3.5,150,164,314
237,150,No math camp,0,4,160,166,326
238,132,No math camp,0,3.1,148,165,313
239,140,No math camp,0,3.06,145,161,306
240,136,No math camp,0,3.98,145,170,315
241,135,Math camp,1,2.44,140,143,283
242,135,No math camp,0,3.36,140,161,301
243,135,No math camp,0,4,154,170,324
244,137,No math camp,0,3.81,141,170,311
245,150,Math camp,1,2.56,142,155,297
246,150,Math camp,1,3.57,150,170,320
247,145,Math camp,1,2.87,140,165,305
248,142,No math camp,0,2.76,144,159,303
249,140,Math camp,1,2.93,139,152,291
250,137,No math camp,0,2.08,141,141,282
251,137,Math camp,1,2.45,140,147,287
252,144,Math camp,1,2.13,137,145,282
253,132,No math camp,0,2.72,146,162,308
254,140,Math camp,1,2.5,139,150,289
255,151,Math camp,1,2.59,153,153,306
256,145,Math camp,1,2.77,141,145,286
257,132,No math camp,0,2.36,139,155,294
258,127,No math camp,0,2.73,150,150,300
259,133,No math camp,0,3.17,141,160,301
260,143,Math camp,1,3.05,140,156,296
261,135,Math camp,1,2.91,139,159,298
262,140,No math camp,0,3.65,146,168,314
263,155,Math camp,1,2.86,144,158,302
264,116,No math camp,0,2.27,146,130,276
265,139,No math camp,0,3.58,145,170,315
266,148,No math camp,0,3.08,146,156,302
267,139,No math camp,0,3.18,144,159,303
268,149,Math camp,1,3.24,146,153,299
269,146,Math camp,1,3.89,148,170,318
270,134,No math camp,0,3.45,144,170,314
271,142,No math camp,0,3.1,146,160,306
272,142,No math camp,0,3.06,139,170,309
273,140,No math camp,0,2.63,145,161,306
274,148,Math camp,1,2.92,138,157,295
275,140,Math camp,1,2.58,136,161,297
276,154,Math camp,1,3.45,150,168,318
277,145,Math camp,1,2.68,143,161,304
278,134,No math camp,0,2.3,136,145,281
279,127,No math camp,0,2.76,140,147,287
280,134,No math camp,0,2.96,145,163,308
281,128,No math camp,0,2.83,145,146,291
282,138,Math camp,1,2.34,143,151,294
283,126,No math camp,0,3.24,144,155,299
284,144,No math camp,0,3.08,144,169,313
285,143,No math camp,0,3.9,151,170,321
286,140,Math camp,1,1.96,143,142,285
287,140,No math camp,0,3.83,149,170,319
288,147,No math camp,0,3,149,164,313
289,141,No math camp,0,3.02,152,155,307
290,150,Math camp,1,3.79,147,170,317
291,154,Math camp,1,2.84,138,157,295
292,137,Math camp,1,2.35,142,146,288
293,140,No math camp,0,3.44,153,161,314
294,144,No math camp,0,3.91,151,170,321
295,141,Math camp,1,2.57,140,164,304
296,147,Math camp,1,2.53,140,163,303
297,137,Math camp,1,2.92,148,150,298
298,137,Math camp,1,2.7,144,150,294
299,144,Math camp,1,2.92,142,158,300
300,146,No math camp,0,2.82,146,162,308
301,146,Math camp,1,2.74,150,157,307
302,129,No math camp,0,2.77,148,151,299
303,145,Math camp,1,2.92,143,154,297
304,122,No math camp,0,1.8,138,140,278
305,151,Math camp,1,3.39,148,170,318
306,159,Math camp,1,2.97,147,156,303
307,138,No math camp,0,3.34,145,160,305
308,133,No math camp,0,3.01,143,170,313
309,136,No math camp,0,3.21,147,162,309
310,147,No math camp,0,3.71,140,170,310
311,143,Math camp,1,2.86,142,170,312
312,152,Math camp,1,2.45,144,154,298
313,150,No math camp,0,3.94,152,170,322
314,151,Math camp,1,2.45,143,148,291
315,130,No math camp,0,2.76,143,147,290
316,133,Math camp,1,2.79,135,153,288
317,133,No math camp,0,3.01,142,154,296
318,145,Math camp,1,2.49,138,157,295
319,147,Math camp,1,3.41,146,162,308
320,134,No math camp,0,3.06,149,160,309
321,142,No math camp,0,3.13,147,167,314
322,141,No math camp,0,2.65,146,155,301
323,147,Math camp,1,3.24,144,156,300
324,146,No math camp,0,3.49,156,169,325
325,138,No math camp,0,3.21,145,164,309
326,144,No math camp,0,3.84,147,168,315
327,141,No math camp,0,2.63,140,157,297
328,152,Math camp,1,3.36,152,167,319
329,137,Math camp,1,2.03,139,147,286
330,155,Math camp,1,3.43,149,166,315
331,131,No math camp,0,2.33,141,146,287
332,144,Math camp,1,2.8,143,164,307
333,148,Math camp,1,2.73,144,149,293
334,147,No math camp,0,2.34,146,157,303
335,125,No math camp,0,2.83,144,154,298
336,138,No math camp,0,3.3,149,158,307
337,132,No math camp,0,3.31,146,163,309
338,136,Math camp,1,2.1,135,146,281
339,135,No math camp,0,3.04,145,159,304
340,136,No math camp,0,3.33,146,159,305
341,136,No math camp,0,3.29,145,164,309
342,127,No math camp,0,2.74,146,161,307
343,121,No math camp,0,1.89,136,138,274
344,144,Math camp,1,2.99,140,164,304
345,153,Math camp,1,2.89,144,158,302
346,134,No math camp,0,2.67,139,158,297
347,139,No math camp,0,3.23,147,159,306
348,136,No math camp,0,3.18,151,147,298
349,137,No math camp,0,3.63,149,170,319
350,142,No math camp,0,3.09,149,162,311
351,150,No math camp,0,4,156,170,326
352,134,No math camp,0,3.03,145,166,311
353,151,Math camp,1,2.71,148,152,300
354,143,Math camp,1,2.82,144,152,296
355,136,Math camp,1,2.44,145,133,278
356,133,No math camp,0,3.03,140,158,298
357,146,Math camp,1,2.27,139,159,298
358,145,No math camp,0,3.41,152,168,320
359,143,Math camp,1,3.15,143,159,302
360,145,Math camp,1,2,135,149,284
361,134,No math camp,0,3.09,141,166,307
362,140,Math camp,1,2.08,138,154,292
363,145,Math camp,1,2.52,146,154,300
364,136,No math camp,0,2.85,148,161,309
365,133,No math camp,0,2.54,147,150,297
366,136,No math camp,0,2.81,144,170,314
367,128,No math camp,0,2.64,146,141,287
368,151,Math camp,1,3.43,141,165,306
369,138,No math camp,0,3.08,143,158,301
370,143,Math camp,1,2.11,136,156,292
371,144,Math camp,1,3.83,150,170,320
372,150,Math camp,1,3.37,149,156,305
373,134,No math camp,0,2.54,146,157,303
374,145,No math camp,0,3.56,147,170,317
375,134,No math camp,0,2.88,148,155,303
376,144,No math camp,0,3.12,151,170,321
377,141,Math camp,1,2.45,143,144,287
378,138,No math camp,0,3.18,151,166,317
379,144,Math camp,1,2.89,143,161,304
380,136,Math camp,1,2.4,142,142,284
381,145,No math camp,0,3.19,159,167,326
382,134,No math camp,0,3.51,151,148,299
383,134,No math camp,0,2.78,146,151,297
384,135,No math camp,0,2.8,135,157,292
385,130,No math camp,0,3.09,148,170,318
386,143,Math camp,1,2.8,140,163,303
387,147,No math camp,0,3.33,144,170,314
388,138,No math camp,0,2.95,146,165,311
389,153,Math camp,1,2.64,153,150,303
390,147,No math camp,0,3.76,144,170,314
391,141,Math camp,1,3.07,132,157,289
392,139,No math camp,0,3.85,159,160,319
393,146,Math camp,1,4,149,170,319
394,139,Math camp,1,2.21,139,150,289
395,127,No math camp,0,3.12,144,166,310
396,133,No math camp,0,3.52,143,170,313
397,143,Math camp,1,2.6,140,150,290
398,138,No math camp,0,2.47,143,154,297
399,144,Math camp,1,2.97,143,157,300
400,154,Math camp,1,3.01,149,156,305
401,141,No math camp,0,3.18,153,163,316
402,138,Math camp,1,2.95,145,160,305
403,141,No math camp,0,2.52,150,156,306
404,151,Math camp,1,3.34,151,165,316
405,148,Math camp,1,3.64,147,170,317
406,141,Math camp,1,2.33,145,151,296
407,153,Math camp,1,2.76,141,165,306
408,134,No math camp,0,3.28,145,152,297
409,146,Math camp,1,2.95,144,152,296
410,140,No math camp,0,2.79,147,160,307
411,153,Math camp,1,3.45,149,159,308
412,136,No math camp,0,2.26,146,147,293
413,131,No math camp,0,3.19,149,162,311
414,126,No math camp,0,2.69,146,133,279
415,130,No math camp,0,2.77,145,154,299
416,139,No math camp,0,2.78,149,157,306
417,136,No math camp,0,2.94,139,162,301
418,151,No math camp,0,2.97,148,159,307
419,143,Math camp,1,2.26,140,146,286
420,139,Math camp,1,2.52,142,148,290
421,152,No math camp,0,3.39,149,160,309
422,141,No math camp,0,3.16,143,163,306
423,129,No math camp,0,2.85,144,155,299
424,148,Math camp,1,3.32,145,167,312
425,137,No math camp,0,2.76,142,159,301
426,147,Math camp,1,2.93,145,161,306
427,140,No math camp,0,2.43,144,167,311
428,142,No math camp,0,3.29,145,167,312
429,152,Math camp,1,3.77,153,170,323
430,140,Math camp,1,2.55,139,152,291
431,161,Math camp,1,3.73,153,170,323
432,137,No math camp,0,3.39,154,160,314
433,147,No math camp,0,2.88,153,163,316
434,139,No math camp,0,3.1,148,159,307
435,150,Math camp,1,3.39,148,165,313
436,124,No math camp,0,1.84,132,138,270
437,139,Math camp,1,2.31,141,159,300
438,152,Math camp,1,2.65,140,154,294
439,138,No math camp,0,3.56,148,160,308
440,147,Math camp,1,2.84,143,154,297
441,148,Math camp,1,2.89,139,154,293
442,141,No math camp,0,3.29,146,166,312
443,141,No math camp,0,3.17,148,169,317
444,137,No math camp,0,3.5,145,158,303
445,155,Math camp,1,3.78,152,170,322
446,141,Math camp,1,2.21,136,147,283
447,140,No math camp,0,3.25,147,170,317
448,144,No math camp,0,3.57,154,170,324
449,131,No math camp,0,2.93,148,167,315
450,151,Math camp,1,2.85,137,167,304
451,135,Math camp,1,2.33,139,142,281
452,127,No math camp,0,2.86,135,157,292
453,141,Math camp,1,2.53,134,149,283
454,148,No math camp,0,3.83,149,170,319
455,133,No math camp,0,2.38,139,149,288
456,137,No math camp,0,3.59,148,168,316
457,136,No math camp,0,2.81,150,149,299
458,147,No math camp,0,3.84,155,170,325
459,144,Math camp,1,2.32,145,147,292
460,144,Math camp,1,2.34,139,160,299
461,140,No math camp,0,3.01,145,162,307
462,148,Math camp,1,2.85,145,148,293
463,151,Math camp,1,3.26,141,161,302
464,149,Math camp,1,2.65,142,158,300
465,137,No math camp,0,3.09,148,153,301
466,148,Math camp,1,3.46,152,168,320
467,150,No math camp,0,3.98,156,170,326
468,134,No math camp,0,2.52,150,146,296
469,135,No math camp,0,2.55,146,145,291
470,129,No math camp,0,2.72,146,154,300
471,144,Math camp,1,2.9,138,162,300
472,128,No math camp,0,2.39,137,147,284
473,138,No math camp,0,3.1,143,161,304
474,130,No math camp,0,2.79,147,154,301
475,145,No math camp,0,3.06,145,160,305
476,159,Math camp,1,2.43,142,151,293
477,131,No math camp,0,4,148,170,318
478,157,Math camp,1,2.85,142,164,306
479,139,No math camp,0,3.11,140,165,305
480,157,No math camp,0,3.79,154,170,324
481,138,No math camp,0,2.73,147,151,298
482,143,Math camp,1,2.8,139,160,299
483,136,No math camp,0,3.65,154,167,321
484,134,No math camp,0,3.15,141,160,301
485,128,No math camp,0,3.09,143,160,303
486,137,Math camp,1,2.99,131,170,301
487,152,Math camp,1,3.7,156,160,316
488,146,No math camp,0,3.56,150,168,318
489,131,No math camp,0,2.38,142,152,294
490,150,Math camp,1,2.92,142,170,312
491,138,Math camp,1,2.75,141,159,300
492,138,No math camp,0,2.92,150,151,301
493,130,Math camp,1,2.61,134,160,294
494,156,Math camp,1,3.64,155,167,322
495,140,No math camp,0,4,150,170,320
496,150,Math camp,1,4,147,170,317
497,134,Math camp,1,2.03,136,153,289
498,134,Math camp,1,2.79,142,158,300
499,146,Math camp,1,2.4,143,156,299
500,151,Math camp,1,2.4,136,154,290
501,140,No math camp,0,3.61,142,170,312
502,143,No math camp,0,3.38,148,157,305
503,148,No math camp,0,2.82,147,169,316
504,139,No math camp,0,3.65,144,168,312
505,143,No math camp,0,3.5,141,170,311
506,149,No math camp,0,3.23,151,170,321
507,142,No math camp,0,3.66,153,167,320
508,145,Math camp,1,3.29,140,162,302
509,143,Math camp,1,2.93,143,159,302
510,142,Math camp,1,2.57,143,150,293
511,146,No math camp,0,2.81,150,153,303
512,141,Math camp,1,3.34,146,158,304
513,142,No math camp,0,2.79,150,164,314
514,138,No math camp,0,3.13,143,170,313
515,134,No math camp,0,3.13,149,164,313
516,141,No math camp,0,3.98,152,170,322
517,150,Math camp,1,3.33,158,158,316
518,129,No math camp,0,2.57,145,159,304
519,142,No math camp,0,3.23,144,167,311
520,145,Math camp,1,2.83,138,160,298
521,130,No math camp,0,3.34,141,170,311
522,149,No math camp,0,3.22,152,170,322
523,136,Math camp,1,2.34,139,153,292
524,146,No math camp,0,3.27,148,169,317
525,142,No math camp,0,3.17,151,166,317
526,146,No math camp,0,3.51,149,166,315
527,138,No math camp,0,3.42,148,168,316
528,131,No math camp,0,2.27,142,146,288
529,134,Math camp,1,3.12,141,154,295
530,154,Math camp,1,2.75,145,158,303
531,133,No math camp,0,3.46,143,166,309
532,147,Math camp,1,3.28,142,168,310
533,138,No math camp,0,2.64,144,150,294
534,136,Math camp,1,2.57,137,158,295
535,132,No math camp,0,2.65,143,156,299
536,137,No math camp,0,4,152,170,322
537,148,Math camp,1,2.89,144,153,297
538,138,No math camp,0,3.11,144,166,310
539,135,No math camp,0,2.91,146,156,302
540,145,No math camp,0,3.13,142,162,304
541,148,Math camp,1,1.8,143,141,284
542,141,Math camp,1,2.53,135,150,285
543,140,No math camp,0,3,144,150,294
544,142,Math camp,1,3.07,145,161,306
545,141,No math camp,0,3.5,146,164,310
546,157,Math camp,1,3.4,149,161,310
547,137,No math camp,0,3.2,152,155,307
548,146,Math camp,1,2.79,145,159,304
549,130,No math camp,0,3.13,146,170,316
550,137,No math camp,0,3.37,143,170,313
551,146,No math camp,0,3.59,154,169,323
552,143,No math camp,0,3.55,151,167,318
553,129,No math camp,0,3.1,146,150,296
554,147,Math camp,1,3.6,147,165,312
555,140,Math camp,1,2.62,143,153,296
556,137,No math camp,0,3.28,141,165,306
557,132,No math camp,0,2.17,149,144,293
558,158,Math camp,1,4,161,170,331
559,143,Math camp,1,2.65,143,162,305
560,149,Math camp,1,2.52,144,158,302
561,133,No math camp,0,2.74,148,154,302
562,145,No math camp,0,3.01,151,159,310
563,154,Math camp,1,2.78,148,159,307
564,140,Math camp,1,2.33,143,147,290
565,136,No math camp,0,2.59,141,154,295
566,150,Math camp,1,2.61,141,162,303
567,140,No math camp,0,3.1,149,159,308
568,142,No math camp,0,2.89,141,155,296
569,147,No math camp,0,3.1,144,170,314
570,132,No math camp,0,3.32,145,156,301
571,140,Math camp,1,2.73,142,148,290
572,150,No math camp,0,3.98,152,169,321
573,140,No math camp,0,3.16,143,162,305
574,152,No math camp,0,3.87,151,170,321
575,142,No math camp,0,2.64,152,155,307
576,131,No math camp,0,3.44,146,161,307
577,150,Math camp,1,3.21,145,168,313
578,140,No math camp,0,3.68,154,162,316
579,146,No math camp,0,3.41,149,169,318
580,142,Math camp,1,3.77,147,166,313
581,157,Math camp,1,3.48,149,164,313
582,137,No math camp,0,3.05,140,158,298
583,142,Math camp,1,2.35,143,150,293
584,135,No math camp,0,2.43,142,144,286
585,147,Math camp,1,2.25,142,149,291
586,135,No math camp,0,3.09,149,162,311
587,157,Math camp,1,3.13,156,158,314
588,138,Math camp,1,2.33,135,145,280
589,135,No math camp,0,3.79,147,170,317
590,142,No math camp,0,3.25,146,162,308
591,132,Math camp,1,2.11,139,137,276
592,145,No math camp,0,3.23,141,166,307
593,139,No math camp,0,3.14,147,170,317
594,136,No math camp,0,2.87,140,159,299
595,144,No math camp,0,3.3,148,170,318
596,150,No math camp,0,3.72,150,170,320
597,144,No math camp,0,2.81,148,159,307
598,131,No math camp,0,3.44,143,170,313
599,144,No math camp,0,3.4,150,165,315
600,130,No math camp,0,3,145,150,295
601,139,Math camp,1,2.2,139,141,280
602,137,No math camp,0,2.85,145,165,310
603,157,Math camp,1,3.4,154,163,317
604,147,Math camp,1,2.9,140,159,299
605,137,No math camp,0,3.08,149,168,317
606,136,No math camp,0,2.92,146,159,305
607,147,No math camp,0,3.06,143,170,313
608,139,No math camp,0,3.14,140,170,310
609,144,Math camp,1,3.11,151,159,310
610,134,No math camp,0,3.21,139,165,304
611,131,No math camp,0,3.45,143,158,301
612,135,No math camp,0,3.23,145,165,310
613,127,No math camp,0,3.09,140,158,298
614,141,No math camp,0,3.45,149,170,319
615,130,No math camp,0,2.81,153,153,306
616,130,No math camp,0,3,144,153,297
617,134,No math camp,0,2.72,138,161,299
618,149,Math camp,1,2.79,145,159,304
619,158,Math camp,1,3.81,148,168,316
620,137,No math camp,0,3.56,146,163,309
621,129,No math camp,0,1.94,141,147,288
622,142,Math camp,1,2.76,141,153,294
623,138,No math camp,0,3.21,148,158,306
624,138,No math camp,0,2.79,148,161,309
625,130,Math camp,1,2.06,139,141,280
626,125,No math camp,0,2.79,133,156,289
627,139,No math camp,0,3.19,152,166,318
628,139,Math camp,1,3.16,146,159,305
629,151,Math camp,1,3.53,144,170,314
630,158,Math camp,1,4,149,170,319
631,132,No math camp,0,3.48,138,170,308
632,143,Math camp,1,2.71,141,160,301
633,156,Math camp,1,3.35,154,163,317
634,137,No math camp,0,2.98,138,153,291
635,129,No math camp,0,3.11,144,144,288
636,131,No math camp,0,2.81,150,149,299
637,139,Math camp,1,2.47,142,147,289
638,148,Math camp,1,2.56,143,151,294
639,143,Math camp,1,2.9,141,152,293
640,135,Math camp,1,2.01,133,138,271
641,144,No math camp,0,3.56,144,170,314
642,135,No math camp,0,3.42,151,170,321
643,135,Math camp,1,2.23,138,136,274
644,135,No math camp,0,3.56,148,168,316
645,153,Math camp,1,3.25,149,170,319
646,145,No math camp,0,3.79,152,170,322
647,138,Math camp,1,2.55,145,151,296
648,147,Math camp,1,3.26,145,166,311
649,141,No math camp,0,3.26,149,163,312
650,126,No math camp,0,3.01,146,162,308
651,147,Math camp,1,2.65,146,149,295
652,142,No math camp,0,3.29,147,162,309
653,143,Math camp,1,2.47,145,149,294
654,139,No math camp,0,2.7,143,158,301
655,132,No math camp,0,2.1,145,144,289
656,125,No math camp,0,3.03,141,156,297
657,133,Math camp,1,2.71,139,156,295
658,141,Math camp,1,2.7,145,152,297
659,128,No math camp,0,3.71,150,170,320
660,149,Math camp,1,2.62,144,158,302
661,147,Math camp,1,3.56,151,165,316
662,138,No math camp,0,3.48,146,170,316
663,150,No math camp,0,3.14,147,159,306
664,134,No math camp,0,3.11,148,155,303
665,133,No math camp,0,3.22,151,154,305
666,158,No math camp,0,3.78,148,170,318
667,142,No math camp,0,3.3,149,158,307
668,139,No math camp,0,2.86,150,153,303
669,123,Math camp,1,1.54,136,138,274
670,150,No math camp,0,3.59,153,170,323
671,143,Math camp,1,2.97,137,158,295
672,146,Math camp,1,2.57,145,159,304
673,141,No math camp,0,2.81,150,155,305
674,142,No math camp,0,3.54,150,170,320
675,140,No math camp,0,3.28,149,167,316
676,146,No math camp,0,3.15,149,170,319
677,134,No math camp,0,2.87,148,159,307
678,121,No math camp,0,2.4,142,155,297
679,145,Math camp,1,3.55,145,166,311
680,147,No math camp,0,4,155,170,325
681,141,Math camp,1,2.92,144,155,299
682,129,No math camp,0,3.42,150,154,304
683,136,Math camp,1,2.6,143,160,303
684,141,No math camp,0,2.52,146,145,291
685,147,No math camp,0,3.72,153,170,323
686,136,Math camp,1,3.12,145,155,300
687,132,No math camp,0,3.08,139,157,296
688,140,No math camp,0,3.93,154,170,324
689,133,No math camp,0,3.17,141,159,300
690,138,No math camp,0,3.22,147,155,302
691,142,Math camp,1,2.69,142,150,292
692,142,Math camp,1,2.71,141,157,298
693,142,No math camp,0,3.01,145,167,312
694,144,Math camp,1,2.46,141,162,303
695,146,No math camp,0,3.06,146,164,310
696,128,No math camp,0,3.44,143,156,299
697,138,Math camp,1,2.9,136,168,304
698,140,No math camp,0,3.23,150,169,319
699,134,No math camp,0,2.69,140,156,296
700,147,Math camp,1,2.63,138,153,291
701,144,Math camp,1,1.91,139,137,276
702,136,Math camp,1,2.41,137,153,290
703,137,No math camp,0,2.78,147,158,305
704,151,Math camp,1,3.34,149,159,308
705,146,No math camp,0,3.21,149,167,316
706,137,Math camp,1,2.51,142,140,282
707,148,Math camp,1,3.03,146,166,312
708,133,No math camp,0,3.06,149,158,307
709,140,Math camp,1,2.61,140,153,293
710,142,No math camp,0,3.42,155,170,325
711,135,Math camp,1,2.26,135,151,286
712,130,No math camp,0,2.44,139,156,295
713,143,No math camp,0,2.88,148,159,307
714,137,No math camp,0,2.69,144,154,298
715,139,No math camp,0,3.33,147,165,312
716,143,No math camp,0,4,154,170,324
717,160,Math camp,1,3.11,156,151,307
718,133,No math camp,0,3.76,144,170,314
719,139,Math camp,1,2.33,142,144,286
720,145,No math camp,0,3.23,139,170,309
721,137,No math camp,0,3.29,152,154,306
722,146,No math camp,0,3,146,155,301
723,130,No math camp,0,3.31,139,165,304
724,152,No math camp,0,3.49,146,170,316
725,154,Math camp,1,3.28,143,162,305
726,149,Math camp,1,3.91,150,170,320
727,138,No math camp,0,3.27,146,168,314
728,133,No math camp,0,3.44,147,168,315
729,149,Math camp,1,2.35,142,146,288
730,141,No math camp,0,3.97,150,170,320
731,134,No math camp,0,3.22,141,170,311
732,141,No math camp,0,3.18,144,170,314
733,139,No math camp,0,3.08,136,161,297
734,137,No math camp,0,2.97,145,156,301
735,138,No math camp,0,2.57,142,144,286
736,138,No math camp,0,3.61,147,170,317
737,142,Math camp,1,2.27,135,146,281
738,145,Math camp,1,3.38,143,160,303
739,141,No math camp,0,3.13,143,160,303
740,152,Math camp,1,2.76,141,154,295
741,144,No math camp,0,3.3,144,170,314
742,138,No math camp,0,3.35,146,164,310
743,138,Math camp,1,3.26,134,170,304
744,135,Math camp,1,2.48,144,139,283
745,148,No math camp,0,3.97,152,170,322
746,145,Math camp,1,3.04,144,160,304
747,128,No math camp,0,2.39,136,155,291
748,154,Math camp,1,3.62,151,170,321
749,146,Math camp,1,2.8,143,154,297
750,142,No math camp,0,3.59,145,170,315
751,141,No math camp,0,3.18,143,159,302
752,138,No math camp,0,3.27,150,170,320
753,146,Math camp,1,2.91,142,166,308
754,131,No math camp,0,3.28,143,162,305
755,153,Math camp,1,3.96,148,170,318
756,141,No math camp,0,3.18,147,170,317
757,146,Math camp,1,2.56,145,141,286
758,139,No math camp,0,2.98,152,155,307
759,140,Math camp,1,2.06,142,138,280
760,147,No math camp,0,2.85,154,160,314
761,152,Math camp,1,3.39,142,168,310
762,142,Math camp,1,2.74,140,145,285
763,145,No math camp,0,3.6,146,164,310
764,133,No math camp,0,2.78,137,162,299
765,145,Math camp,1,2.41,144,147,291
766,146,Math camp,1,2.75,141,165,306
767,145,No math camp,0,3.19,150,170,320
768,150,Math camp,1,3.36,144,160,304
769,137,No math camp,0,3.06,144,164,308
770,138,Math camp,1,2.66,142,160,302
771,130,Math camp,1,2.12,132,155,287
772,147,No math camp,0,3.43,155,170,325
773,145,No math camp,0,3.81,149,170,319
774,127,No math camp,0,2.17,138,147,285
775,131,No math camp,0,2.87,144,160,304
776,143,Math camp,1,2.59,144,149,293
777,140,No math camp,0,3.83,149,166,315
778,132,No math camp,0,2.65,146,153,299
779,129,No math camp,0,2.69,146,154,300
780,149,Math camp,1,3.25,147,167,314
781,135,Math camp,1,2.3,135,149,284
782,124,No math camp,0,2.38,147,148,295
783,143,Math camp,1,3.39,151,159,310
784,149,Math camp,1,2.77,143,159,302
785,118,No math camp,0,2.42,139,139,278
786,161,Math camp,1,3.65,150,170,320
787,140,No math camp,0,3.92,142,170,312
788,132,No math camp,0,3.44,152,147,299
789,137,No math camp,0,2.86,149,159,308
790,147,No math camp,0,3.7,149,170,319
791,134,No math camp,0,3.35,142,167,309
792,130,No math camp,0,3.3,143,158,301
793,141,Math camp,1,2.76,147,148,295
794,128,Math camp,1,3.04,141,158,299
795,143,Math camp,1,2.45,149,159,308
796,140,No math camp,0,3.13,150,170,320
797,127,No math camp,0,1.87,137,142,279
798,140,No math camp,0,3.11,148,160,308
799,147,No math camp,0,3.83,150,169,319
800,143,No math camp,0,3.41,152,164,316
801,134,No math camp,0,2.77,148,150,298
802,159,No math camp,0,3.84,154,170,324
803,131,No math camp,0,3.36,145,166,311
804,129,Math camp,1,1.68,136,144,280
805,151,Math camp,1,2.72,145,154,299
806,132,Math camp,1,2.78,140,157,297
807,137,No math camp,0,3.17,149,158,307
808,143,No math camp,0,3.11,148,165,313
809,150,Math camp,1,2.59,144,158,302
810,137,No math camp,0,3.91,146,170,316
811,135,Math camp,1,2.96,138,156,294
812,139,Math camp,1,2.57,142,155,297
813,138,No math camp,0,3.14,150,163,313
814,147,Math camp,1,3.06,144,151,295
815,136,Math camp,1,1.83,132,145,277
816,130,No math camp,0,3.2,141,155,296
817,142,Math camp,1,2.81,142,152,294
818,143,No math camp,0,2.89,148,162,310
819,140,Math camp,1,2.75,145,150,295
820,137,No math camp,0,3.41,153,170,323
821,129,No math camp,0,3.23,146,153,299
822,142,Math camp,1,2.27,138,146,284
823,142,No math camp,0,3.56,146,161,307
824,132,No math camp,0,2.86,142,161,303
825,130,No math camp,0,3.13,139,168,307
826,138,No math camp,0,3.66,141,170,311
827,150,No math camp,0,3.37,145,165,310
828,144,No math camp,0,2.62,150,156,306
829,147,Math camp,1,3.01,146,150,296
830,152,Math camp,1,3.51,147,170,317
831,138,No math camp,0,3.25,146,163,309
832,141,Math camp,1,3.31,145,166,311
833,134,No math camp,0,3.49,147,165,312
834,144,Math camp,1,2.62,141,154,295
835,148,Math camp,1,2.86,142,160,302
836,145,Math camp,1,2.5,141,157,298
837,137,Math camp,1,2.1,135,154,289
838,142,No math camp,0,3.35,148,170,318
839,133,No math camp,0,3.22,148,161,309
840,138,No math camp,0,2.91,145,158,303
841,140,No math camp,0,3.18,154,160,314
842,147,Math camp,1,2.74,142,153,295
843,142,No math camp,0,3.57,150,170,320
844,151,No math camp,0,4,148,170,318
845,142,No math camp,0,3.77,148,170,318
846,148,Math camp,1,3.08,150,155,305
847,124,No math camp,0,2.84,139,147,286
848,134,No math camp,0,2.84,147,145,292
849,145,No math camp,0,3.36,144,170,314
850,147,No math camp,0,3.49,156,166,322
851,139,Math camp,1,2.55,144,149,293
852,137,No math camp,0,3.05,142,162,304
853,131,No math camp,0,2.95,151,153,304
854,136,Math camp,1,2.33,138,152,290
855,135,No math camp,0,2.85,146,150,296
856,137,Math camp,1,2.24,145,141,286
857,140,Math camp,1,2.83,144,158,302
858,138,No math camp,0,2.75,148,157,305
859,146,No math camp,0,3.97,154,170,324
860,147,Math camp,1,2.46,142,151,293
861,145,No math camp,0,2.91,149,159,308
862,137,No math camp,0,3.53,145,170,315
863,133,No math camp,0,3.17,147,160,307
864,145,No math camp,0,3.51,146,160,306
865,131,No math camp,0,3.5,148,170,318
866,136,No math camp,0,3.23,143,167,310
867,144,Math camp,1,2.98,143,160,303
868,146,No math camp,0,3.58,147,170,317
869,137,No math camp,0,3.58,153,161,314
870,138,Math camp,1,2.77,138,161,299
871,141,Math camp,1,2.67,141,147,288
872,127,No math camp,0,2.9,145,149,294
873,140,No math camp,0,2.91,149,164,313
874,143,Math camp,1,2.64,139,146,285
875,134,No math camp,0,2.89,151,151,302
876,145,Math camp,1,3.64,145,170,315
877,146,No math camp,0,3.19,147,169,316
878,137,No math camp,0,3.24,141,170,311
879,142,No math camp,0,3.12,140,165,305
880,154,Math camp,1,3.19,149,164,313
881,159,Math camp,1,3.58,150,170,320
882,141,No math camp,0,4,150,170,320
883,139,Math camp,1,2.44,144,145,289
884,129,No math camp,0,2.88,140,160,300
885,147,Math camp,1,2.47,137,158,295
886,144,Math camp,1,2.69,142,160,302
887,141,Math camp,1,3.55,150,156,306
888,137,No math camp,0,2.82,139,157,296
889,139,Math camp,1,2.18,142,152,294
890,121,No math camp,0,1.86,137,135,272
891,140,No math camp,0,3.78,148,169,317
892,140,Math camp,1,2.55,138,153,291
893,134,Math camp,1,2.72,137,151,288
894,149,Math camp,1,2.45,143,155,298
895,146,No math camp,0,3.53,150,170,320
896,141,No math camp,0,3.02,142,165,307
897,141,Math camp,1,2.51,144,152,296
898,143,No math camp,0,2.88,148,162,310
899,132,No math camp,0,3.23,135,164,299
900,133,No math camp,0,2.8,144,163,307
901,141,No math camp,0,3.64,155,156,311
902,139,Math camp,1,2.46,144,145,289
903,142,No math camp,0,3.84,152,169,321
904,145,No math camp,0,3.06,146,170,316
905,145,No math camp,0,3.58,147,169,316
906,152,Math camp,1,2.73,142,160,302
907,155,Math camp,1,3.48,143,170,313
908,138,No math camp,0,3.4,148,170,318
909,143,Math camp,1,1.84,144,138,282
910,140,No math camp,0,2.92,149,162,311
911,146,Math camp,1,2.38,143,149,292
912,155,No math camp,0,3.89,151,170,321
913,137,No math camp,0,2.6,145,161,306
914,145,Math camp,1,2.72,147,154,301
915,135,No math camp,0,3.4,148,163,311
916,133,No math camp,0,2.91,144,153,297
917,138,Math camp,1,2.55,135,157,292
918,144,No math camp,0,3.16,153,157,310
919,141,No math camp,0,3.42,146,165,311
920,142,No math camp,0,3.52,147,170,317
921,139,No math camp,0,3.72,148,170,318
922,149,Math camp,1,3.28,150,169,319
923,135,No math camp,0,3.4,142,166,308
924,144,No math camp,0,3.3,143,163,306
925,129,No math camp,0,3.4,144,158,302
926,136,No math camp,0,3.24,143,167,310
927,132,No math camp,0,3.16,147,168,315
928,134,No math camp,0,3.22,140,164,304
929,142,No math camp,0,3,153,159,312
930,141,No math camp,0,3.15,149,160,309
931,142,Math camp,1,2.34,139,137,276
932,134,Math camp,1,2.4,138,150,288
933,142,No math camp,0,3.24,149,166,315
934,135,No math camp,0,2.92,148,151,299
935,146,Math camp,1,2.98,144,166,310
936,144,No math camp,0,3.45,147,170,317
937,133,No math camp,0,2.77,148,147,295
938,141,Math camp,1,2.49,136,159,295
939,144,Math camp,1,2.68,138,160,298
940,140,No math camp,0,4,151,170,321
941,137,Math camp,1,1.71,134,145,279
942,143,No math camp,0,3.53,151,160,311
943,131,No math camp,0,2.31,142,145,287
944,130,No math camp,0,3.34,148,158,306
945,142,No math camp,0,2.54,147,151,298
946,138,No math camp,0,3.64,147,170,317
947,143,Math camp,1,2.99,142,159,301
948,141,No math camp,0,3.66,152,170,322
949,150,No math camp,0,4,163,170,333
950,132,No math camp,0,2.52,144,149,293
951,134,No math camp,0,2.25,147,142,289
952,137,Math camp,1,2.57,144,154,298
953,136,No math camp,0,3.15,148,158,306
954,141,Math camp,1,2.71,141,157,298
955,142,No math camp,0,4,147,170,317
956,133,No math camp,0,3.03,145,168,313
957,143,No math camp,0,3.28,152,165,317
958,152,Math camp,1,2.67,148,158,306
959,149,Math camp,1,2.97,142,158,300
960,126,No math camp,0,2.97,141,152,293
961,137,Math camp,1,2.06,134,145,279
962,147,Math camp,1,3.71,152,162,314
963,147,Math camp,1,2.95,139,157,296
964,146,Math camp,1,3.32,145,165,310
965,142,Math camp,1,2.75,140,159,299
966,138,Math camp,1,2.61,144,150,294
967,163,Math camp,1,3.37,156,154,310
968,137,No math camp,0,2.82,145,163,308
969,143,Math camp,1,2.87,144,154,298
970,138,No math camp,0,3.31,146,155,301
971,147,No math camp,0,3.29,150,165,315
972,146,Math camp,1,2.74,144,154,298
973,144,Math camp,1,2.22,132,152,284
974,147,Math camp,1,2.75,142,153,295
975,139,No math camp,0,3.35,149,162,311
976,141,Math camp,1,2.17,135,151,286
977,138,No math camp,0,3.03,142,151,293
978,145,No math camp,0,3.5,151,169,320
979,152,No math camp,0,3.66,157,170,327
980,137,No math camp,0,3.33,144,156,300
981,147,Math camp,1,2.97,138,169,307
982,146,Math camp,1,2.76,144,165,309
983,142,Math camp,1,1.79,143,145,288
984,150,Math camp,1,3.57,147,170,317
985,147,Math camp,1,2.61,144,155,299
986,127,Math camp,1,2.54,135,142,277
987,140,No math camp,0,3.56,146,170,316
988,143,No math camp,0,3.1,145,164,309
989,134,No math camp,0,3.09,138,160,298
990,147,Math camp,1,2.82,146,157,303
991,140,Math camp,1,2.86,148,167,315
992,154,Math camp,1,3.65,146,163,309
993,147,Math camp,1,2.31,141,159,300
994,132,No math camp,0,3.32,140,170,310
995,131,No math camp,0,3.45,149,153,302
996,142,Math camp,1,2.83,140,147,287
997,145,No math camp,0,3.33,146,170,316
998,139,Math camp,1,2.62,140,150,290
999,148,Math camp,1,2.76,141,158,299
1000,146,Math camp,1,3.01,145,156,301
1001,144,No math camp,0,3.66,150,166,316
1002,144,Math camp,1,2.66,143,154,297
1003,137,No math camp,0,3.54,150,160,310
1004,132,Math camp,1,2.32,138,143,281
1005,132,Math camp,1,2.46,138,146,284
1006,139,No math camp,0,3.35,155,161,316
1007,137,No math camp,0,2.77,145,167,312
1008,136,No math camp,0,3.05,144,157,301
1009,144,No math camp,0,3.4,152,170,322
1010,142,Math camp,1,2.19,144,150,294
1011,146,Math camp,1,2.7,141,163,304
1012,137,No math camp,0,2.07,136,147,283
1013,133,No math camp,0,2.72,149,148,297
1014,137,Math camp,1,2.67,143,146,289
1015,142,No math camp,0,3.43,144,168,312
1016,136,Math camp,1,2.09,141,139,280
1017,156,Math camp,1,3.41,148,168,316
1018,145,No math camp,0,3.97,158,170,328
1019,136,No math camp,0,3.26,145,161,306
1020,143,No math camp,0,3.8,146,162,308
1021,138,Math camp,1,2.37,143,146,289
1022,128,No math camp,0,2.96,148,154,302
1023,143,No math camp,0,3.34,147,168,315
1024,143,No math camp,0,3.33,144,156,300
1025,141,No math camp,0,3.39,149,168,317
1026,134,No math camp,0,2.91,143,151,294
1027,131,No math camp,0,2.74,138,158,296
1028,139,No math camp,0,2.47,142,155,297
1029,144,No math camp,0,3.09,149,166,315
1030,138,No math camp,0,3.41,152,165,317
1031,144,Math camp,1,2.47,138,151,289
1032,150,Math camp,1,3.19,150,156,306
1033,147,Math camp,1,3.55,151,166,317
1034,138,No math camp,0,3.37,147,160,307
1035,131,No math camp,0,2.87,145,147,292
1036,132,No math camp,0,3.3,150,163,313
1037,150,Math camp,1,3.2,144,170,314
1038,132,No math camp,0,2.78,144,154,298
1039,138,No math camp,0,2.49,151,153,304
1040,139,No math camp,0,3.68,141,170,311
1041,136,No math camp,0,3.66,144,170,314
1042,132,No math camp,0,3.1,151,158,309
1043,134,No math camp,0,3.16,147,161,308
1044,144,Math camp,1,2.77,143,159,302
1045,143,Math camp,1,2.84,136,165,301
1046,146,Math camp,1,2.95,135,159,294
1047,140,No math camp,0,3.06,144,169,313
1048,148,No math camp,0,3.14,148,167,315
1049,131,No math camp,0,3.34,146,148,294
1050,138,No math camp,0,2.48,147,146,293
1051,139,No math camp,0,2.82,149,161,310
1052,144,No math camp,0,3.35,145,170,315
1053,147,No math camp,0,3.63,153,170,323
1054,142,Math camp,1,2.71,142,151,293
1055,145,Math camp,1,2.47,137,158,295
1056,147,Math camp,1,2.61,143,155,298
1057,133,No math camp,0,3.04,146,159,305
1058,143,No math camp,0,2.9,148,159,307
1059,141,Math camp,1,2.77,141,151,292
1060,141,No math camp,0,3.43,146,159,305
1061,137,No math camp,0,2.38,138,153,291
1062,134,No math camp,0,2.48,149,155,304
1063,140,Math camp,1,2.76,146,152,298
1064,143,No math camp,0,3.04,148,156,304
1065,130,No math camp,0,3.35,138,164,302
1066,144,Math camp,1,3.36,149,158,307
1067,136,No math camp,0,2.58,146,150,296
1068,153,Math camp,1,3.41,146,170,316
1069,144,No math camp,0,3.71,150,170,320
1070,145,Math camp,1,2.77,142,155,297
1071,151,No math camp,0,3.6,151,165,316
1072,143,No math camp,0,4,149,170,319
1073,135,No math camp,0,2.96,152,152,304
1074,138,No math camp,0,3.63,149,168,317
1075,137,Math camp,1,2.9,136,157,293
1076,134,No math camp,0,3.01,142,158,300
1077,140,Math camp,1,2.72,143,153,296
1078,144,No math camp,0,3.88,153,170,323
1079,139,No math camp,0,3.55,150,170,320
1080,140,No math camp,0,2.71,148,149,297
1081,141,No math camp,0,3.27,144,164,308
1082,126,No math camp,0,2.18,137,141,278
1083,143,No math camp,0,3.35,143,165,308
1084,160,Math camp,1,3.78,153,170,323
1085,142,Math camp,1,2.24,143,150,293
1086,141,No math camp,0,2.84,147,165,312
1087,139,Math camp,1,1.97,138,141,279
1088,142,Math camp,1,2.27,143,140,283
1089,133,No math camp,0,2.57,148,144,292
1090,133,No math camp,0,2.53,146,154,300
1091,147,No math camp,0,3.49,144,170,314
1092,140,Math camp,1,1.74,142,152,294
1093,151,Math camp,1,3.12,147,165,312
1094,139,No math camp,0,2.37,148,160,308
1095,143,No math camp,0,2.84,151,167,318
1096,132,Math camp,1,2.11,137,155,292
1097,130,Math camp,1,2.56,136,153,289
1098,131,No math camp,0,2.81,146,156,302
1099,135,No math camp,0,3.29,147,167,314
1100,121,No math camp,0,2.91,144,157,301
1101,149,Math camp,1,1.92,146,145,291
1102,146,Math camp,1,2.94,147,157,304
1103,142,Math camp,1,2.71,143,152,295
1104,137,No math camp,0,3.65,152,170,322
1105,141,No math camp,0,3.83,148,166,314
1106,130,No math camp,0,3.26,142,168,310
1107,127,No math camp,0,3.12,139,159,298
1108,149,Math camp,1,2.48,145,145,290
1109,145,Math camp,1,2.51,138,155,293
1110,141,No math camp,0,3.16,143,157,300
1111,150,Math camp,1,2.8,149,161,310
1112,136,No math camp,0,2.72,148,151,299
1113,130,No math camp,0,2.96,146,161,307
1114,137,No math camp,0,3.03,148,163,311
1115,140,No math camp,0,3.29,143,163,306
1116,161,Math camp,1,3.15,144,165,309
1117,126,No math camp,0,1.95,137,139,276
1118,129,No math camp,0,3.09,141,159,300
1119,137,No math camp,0,2.22,146,160,306
1120,127,No math camp,0,2.47,143,160,303
1121,129,No math camp,0,2.9,155,143,298
1122,149,No math camp,0,3.41,149,170,319
1123,136,No math camp,0,3.67,144,170,314
1124,133,No math camp,0,2.83,150,153,303
1125,136,No math camp,0,2.48,148,146,294
1126,146,No math camp,0,3.5,149,170,319
1127,136,No math camp,0,3.19,146,160,306
1128,130,No math camp,0,2.52,148,137,285
1129,145,Math camp,1,2.53,141,155,296
1130,134,No math camp,0,3.14,146,154,300
1131,136,No math camp,0,3.07,143,161,304
1132,138,No math camp,0,3.05,145,166,311
1133,150,Math camp,1,2.71,142,168,310
1134,136,No math camp,0,2.53,148,160,308
1135,147,Math camp,1,3.61,144,170,314
1136,135,No math camp,0,2.89,140,162,302
1137,137,No math camp,0,3.02,151,165,316
1138,136,No math camp,0,3.27,151,157,308
1139,151,No math camp,0,2.99,147,164,311
1140,148,Math camp,1,3.14,140,168,308
1141,147,Math camp,1,3.17,149,153,302
1142,141,Math camp,1,2.43,139,153,292
1143,135,Math camp,1,2.53,139,141,280
1144,136,No math camp,0,2.61,146,156,302
1145,148,Math camp,1,4,149,170,319
1146,153,Math camp,1,2.83,144,167,311
1147,141,Math camp,1,2.39,138,154,292
1148,132,No math camp,0,3.04,137,165,302
1149,140,No math camp,0,2.43,149,146,295
1150,134,No math camp,0,2.44,140,150,290
1151,137,Math camp,1,2.49,141,140,281
1152,139,No math camp,0,2.98,149,156,305
1153,149,Math camp,1,2.99,143,161,304
1154,141,No math camp,0,3.26,146,166,312
1155,133,No math camp,0,2.97,141,161,302
1156,114,No math camp,0,2.26,137,154,291
1157,140,Math camp,1,2.54,136,148,284
1158,146,No math camp,0,2.94,147,154,301
1159,135,No math camp,0,3.46,147,170,317
1160,139,No math camp,0,3.15,141,170,311
1161,137,No math camp,0,3.04,145,170,315
1162,132,No math camp,0,2.92,150,149,299
1163,144,No math camp,0,3.31,144,170,314
1164,130,No math camp,0,3.13,148,164,312
1165,144,No math camp,0,4,149,170,319
1166,133,No math camp,0,3.15,146,151,297
1167,143,No math camp,0,2.55,143,145,288
1168,134,No math camp,0,2.14,142,149,291
1169,143,No math camp,0,3.3,140,170,310
1170,131,No math camp,0,3.53,143,167,310
1171,152,Math camp,1,2.91,145,157,302
1172,130,No math camp,0,2.99,145,158,303
1173,142,No math camp,0,3.56,142,170,312
1174,140,No math camp,0,3.35,150,162,312
1175,143,Math camp,1,2.6,141,149,290
1176,130,No math camp,0,3.05,143,170,313
1177,143,Math camp,1,2.79,137,155,292
1178,140,No math camp,0,3.19,143,165,308
1179,148,Math camp,1,3.41,149,160,309
1180,138,No math camp,0,2.68,148,151,299
1181,154,Math camp,1,3.28,147,160,307
1182,136,No math camp,0,2.95,147,146,293
1183,152,Math camp,1,4,146,170,316
1184,137,Math camp,1,2.6,139,157,296
1185,137,No math camp,0,3.55,153,155,308
1186,148,Math camp,1,2.57,143,158,301
1187,140,No math camp,0,2.99,149,164,313
1188,141,Math camp,1,2.67,143,143,286
1189,152,Math camp,1,2.93,138,155,293
1190,146,Math camp,1,2.59,139,151,290
1191,152,Math camp,1,3.36,147,170,317
1192,142,No math camp,0,3.65,149,167,316
1193,148,No math camp,0,4,152,170,322
1194,136,No math camp,0,3.15,152,156,308
1195,151,Math camp,1,2.7,143,170,313
1196,140,No math camp,0,4,149,170,319
1197,133,No math camp,0,3.16,146,156,302
1198,140,No math camp,0,4,155,170,325
1199,144,No math camp,0,3.03,149,162,311
1200,143,No math camp,0,2.83,147,155,302
1201,155,Math camp,1,3.12,152,159,311
1202,127,No math camp,0,2.17,133,153,286
1203,139,No math camp,0,3.22,143,170,313
1204,146,No math camp,0,4,150,170,320
1205,152,Math camp,1,2.97,144,170,314
1206,144,Math camp,1,2.86,145,170,315
1207,151,Math camp,1,2.69,143,159,302
1208,139,No math camp,0,3.22,144,166,310
1209,154,Math camp,1,2.99,142,156,298
1210,141,No math camp,0,3.23,145,170,315
1211,149,No math camp,0,3.46,151,166,317
1212,140,Math camp,1,2.29,143,137,280
1213,138,No math camp,0,2.78,150,154,304
1214,145,Math camp,1,2.57,146,153,299
1215,152,No math camp,0,3.2,147,169,316
1216,138,Math camp,1,2.51,136,144,280
1217,146,Math camp,1,2.76,139,152,291
1218,131,Math camp,1,2.51,134,150,284
1219,144,Math camp,1,2.29,142,150,292
1220,128,No math camp,0,3.2,138,166,304
1221,152,Math camp,1,3.21,141,168,309
1222,140,No math camp,0,3.37,150,168,318
1223,144,Math camp,1,2.44,142,154,296
1224,138,No math camp,0,2.99,145,165,310
1225,145,Math camp,1,2.71,145,156,301
1226,139,No math camp,0,3.28,148,160,308
1227,142,Math camp,1,2.91,141,158,299
1228,151,Math camp,1,3.56,143,167,310
1229,125,No math camp,0,3.04,146,158,304
1230,135,Math camp,1,2.67,145,164,309
1231,146,No math camp,0,3.01,143,168,311
1232,139,Math camp,1,2.49,144,159,303
1233,153,Math camp,1,3.84,159,168,327
1234,127,No math camp,0,3.09,149,157,306
1235,149,Math camp,1,2.51,136,148,284
1236,136,No math camp,0,3.19,149,161,310
1237,138,No math camp,0,3.04,141,159,300
1238,138,No math camp,0,2.91,148,165,313
1239,142,Math camp,1,2.76,137,155,292
1240,141,No math camp,0,3.37,147,162,309
1241,141,No math camp,0,3.45,152,170,322
1242,140,Math camp,1,2.96,142,158,300
1243,143,Math camp,1,2.15,139,151,290
1244,150,Math camp,1,2.93,144,156,300
1245,129,No math camp,0,3.05,143,161,304
1246,136,No math camp,0,3.25,149,156,305
1247,150,Math camp,1,2.62,144,159,303
1248,129,No math camp,0,3.06,140,155,295
1249,147,Math camp,1,3.68,143,170,313
1250,124,No math camp,0,2.71,146,152,298
1251,145,Math camp,1,2.08,138,152,290
1252,142,No math camp,0,2.2,146,148,294
1253,137,No math camp,0,2.81,146,160,306
1254,138,No math camp,0,2.67,146,155,301
1255,146,No math camp,0,2.28,141,151,292
1256,143,No math camp,0,3.37,147,161,308
1257,147,Math camp,1,3.45,147,170,317
1258,136,Math camp,1,2.65,141,155,296
1259,141,No math camp,0,3.52,152,166,318
1260,145,Math camp,1,2.95,149,169,318
1261,143,No math camp,0,2.58,147,150,297
1262,139,Math camp,1,1.74,137,142,279
1263,140,No math camp,0,2.45,143,156,299
1264,137,No math camp,0,2.85,152,150,302
1265,139,No math camp,0,3.35,140,168,308
1266,135,No math camp,0,2.86,145,161,306
1267,132,No math camp,0,3.29,143,154,297
1268,138,No math camp,0,3.17,147,163,310
1269,129,No math camp,0,2.95,149,152,301
1270,138,No math camp,0,3.32,144,168,312
1271,143,No math camp,0,2.92,153,154,307
1272,122,No math camp,0,2.17,140,137,277
1273,127,No math camp,0,2.65,140,151,291
1274,143,Math camp,1,2.16,141,139,280
1275,139,Math camp,1,2.12,138,143,281
1276,150,Math camp,1,2.42,145,151,296
1277,142,Math camp,1,2.54,139,168,307
1278,137,No math camp,0,2.6,149,151,300
1279,132,No math camp,0,2.7,138,161,299
1280,149,No math camp,0,3.96,153,170,323
1281,159,No math camp,0,3.42,156,170,326
1282,145,No math camp,0,3.88,152,170,322
1283,132,No math camp,0,3.33,153,161,314
1284,140,Math camp,1,2.12,137,149,286
1285,148,Math camp,1,3.91,144,170,314
1286,141,Math camp,1,2.13,137,147,284
1287,143,No math camp,0,3.99,151,170,321
1288,152,Math camp,1,3.34,144,166,310
1289,142,Math camp,1,1.6,141,142,283
1290,147,Math camp,1,2.95,137,157,294
1291,150,Math camp,1,3.05,141,160,301
1292,151,Math camp,1,3.44,142,165,307
1293,140,No math camp,0,2.83,150,153,303
1294,139,No math camp,0,3.31,144,166,310
1295,149,Math camp,1,3.11,146,161,307
1296,134,No math camp,0,3.01,148,159,307
1297,148,Math camp,1,1.75,136,142,278
1298,135,No math camp,0,2.3,147,144,291
1299,144,Math camp,1,3.03,140,155,295
1300,141,Math camp,1,2.71,142,156,298
1301,141,Math camp,1,2.11,141,151,292
1302,134,No math camp,0,2.31,143,149,292
1303,144,Math camp,1,2.21,136,154,290
1304,148,Math camp,1,2.9,145,163,308
1305,132,No math camp,0,2.17,147,145,292
1306,146,Math camp,1,2.44,145,151,296
1307,136,No math camp,0,3.17,143,166,309
1308,138,No math camp,0,3.7,155,164,319
1309,137,No math camp,0,3.66,146,170,316
1310,139,No math camp,0,3.57,148,170,318
1311,137,No math camp,0,3.27,146,164,310
1312,144,Math camp,1,3.07,141,155,296
1313,125,No math camp,0,2.77,151,144,295
1314,144,Math camp,1,2.48,143,152,295
1315,134,No math camp,0,2.2,145,147,292
1316,141,No math camp,0,3.09,150,165,315
1317,145,No math camp,0,4,161,170,331
1318,148,Math camp,1,2.69,150,159,309
1319,138,No math camp,0,3.19,143,161,304
1320,133,No math camp,0,2.99,147,162,309
1321,139,Math camp,1,2.94,145,151,296
1322,138,No math camp,0,3.29,141,161,302
1323,146,No math camp,0,3.94,148,170,318
1324,148,Math camp,1,2.41,138,147,285
1325,152,Math camp,1,2.89,144,165,309
1326,145,No math camp,0,3.07,144,170,314
1327,144,Math camp,1,2.77,141,158,299
1328,128,No math camp,0,2.91,146,156,302
1329,148,No math camp,0,3.58,149,170,319
1330,135,Math camp,1,2.97,139,163,302
1331,150,No math camp,0,3.67,146,170,316
1332,148,Math camp,1,2.77,144,158,302
1333,130,No math camp,0,2.28,142,158,300
1334,157,Math camp,1,3.32,149,165,314
1335,151,Math camp,1,2.7,150,164,314
1336,134,No math camp,0,3.01,139,164,303
1337,146,No math camp,0,3.31,149,169,318
1338,143,Math camp,1,2.41,141,145,286
1339,132,Math camp,1,2.88,144,154,298
1340,135,Math camp,1,1.86,136,141,277
1341,147,No math camp,0,3.2,142,160,302
1342,143,Math camp,1,2.77,143,153,296
1343,134,Math camp,1,2.27,141,134,275
1344,146,No math camp,0,3.42,152,170,322
1345,148,No math camp,0,4,156,170,326
1346,142,No math camp,0,4,142,170,312
1347,139,Math camp,1,2.15,140,147,287
1348,144,No math camp,0,3.52,155,170,325
1349,151,Math camp,1,2.04,141,141,282
1350,138,Math camp,1,2.54,140,148,288
1351,129,No math camp,0,2.9,136,144,280
1352,142,No math camp,0,3.57,150,170,320
1353,136,No math camp,0,2.46,142,165,307
1354,139,No math camp,0,2.79,141,154,295
1355,141,No math camp,0,2.91,138,163,301
1356,144,Math camp,1,2.61,141,152,293
1357,141,No math camp,0,3.2,146,170,316
1358,125,No math camp,0,3.06,146,156,302
1359,143,Math camp,1,2.08,134,157,291
1360,141,No math camp,0,2.62,146,156,302
1361,155,Math camp,1,2.93,143,150,293
1362,150,Math camp,1,3.01,145,164,309
1363,151,Math camp,1,2.77,142,157,299
1364,153,Math camp,1,3.57,144,170,314
1365,158,Math camp,1,2.88,151,158,309
1366,144,No math camp,0,3.47,150,170,320
1367,148,Math camp,1,2.51,141,163,304
1368,135,No math camp,0,3.25,146,161,307
1369,140,Math camp,1,2.84,144,152,296
1370,137,No math camp,0,3.02,143,164,307
1371,137,No math camp,0,2.96,148,158,306
1372,146,Math camp,1,2.3,138,149,287
1373,143,No math camp,0,3.03,149,170,319
1374,141,No math camp,0,3.08,144,161,305
1375,151,No math camp,0,3.46,152,161,313
1376,144,Math camp,1,2.95,143,152,295
1377,144,Math camp,1,2.6,136,161,297
1378,141,No math camp,0,3.48,148,170,318
1379,136,No math camp,0,2.95,149,170,319
1380,145,No math camp,0,3.76,149,169,318
1381,128,No math camp,0,2.7,150,146,296
1382,135,Math camp,1,1.84,139,138,277
1383,136,Math camp,1,2.42,134,149,283
1384,146,No math camp,0,3.87,153,170,323
1385,150,Math camp,1,2.89,141,161,302
1386,137,No math camp,0,2.41,142,149,291
1387,147,No math camp,0,3.36,147,165,312
1388,138,No math camp,0,3.19,138,170,308
1389,148,Math camp,1,2.94,151,158,309
1390,136,No math camp,0,3.31,148,169,317
1391,133,No math camp,0,3.72,145,170,315
1392,142,No math camp,0,3.32,153,166,319
1393,133,Math camp,1,2.29,137,147,284
1394,134,No math camp,0,2.72,144,152,296
1395,143,Math camp,1,2.74,138,159,297
1396,127,No math camp,0,2.81,147,159,306
1397,141,No math camp,0,3.55,148,167,315
1398,150,No math camp,0,3.43,151,162,313
1399,134,No math camp,0,2.95,151,155,306
1400,142,Math camp,1,2.01,143,139,282
1401,143,No math camp,0,3.65,152,161,313
1402,155,Math camp,1,3.32,152,160,312
1403,140,Math camp,1,2.77,134,160,294
1404,132,No math camp,0,2.82,142,151,293
1405,141,Math camp,1,1.9,136,142,278
1406,144,Math camp,1,2.81,135,159,294
1407,137,No math camp,0,3.21,146,167,313
1408,132,No math camp,0,2.82,144,156,300
1409,134,No math camp,0,2.79,145,159,304
1410,140,No math camp,0,3.3,143,169,312
1411,142,No math camp,0,3.43,144,170,314
1412,127,No math camp,0,2.91,153,149,302
1413,136,Math camp,1,2.87,142,154,296
1414,147,Math camp,1,2.8,143,160,303
1415,154,Math camp,1,2.99,149,164,313
1416,136,No math camp,0,3.2,144,164,308
1417,140,No math camp,0,3.08,144,169,313
1418,142,No math camp,0,3.25,147,166,313
1419,134,No math camp,0,3.03,137,165,302
1420,142,Math camp,1,2.98,142,160,302
1421,139,No math camp,0,2.93,154,156,310
1422,141,No math camp,0,2.46,146,151,297
1423,146,No math camp,0,3.63,148,170,318
1424,139,Math camp,1,2.74,137,144,281
1425,129,No math camp,0,2.51,147,140,287
1426,137,No math camp,0,3.63,151,159,310
1427,142,No math camp,0,3.58,148,170,318
1428,136,Math camp,1,2.86,139,155,294
1429,150,No math camp,0,3.99,154,170,324
1430,140,Math camp,1,2.45,140,147,287
1431,136,No math camp,0,2.78,139,153,292
1432,140,No math camp,0,3.06,145,170,315
1433,143,Math camp,1,2.92,140,156,296
1434,147,Math camp,1,2.84,145,160,305
1435,150,Math camp,1,3.56,150,161,311
1436,148,Math camp,1,3.11,148,161,309
1437,142,Math camp,1,2.63,141,157,298
1438,128,No math camp,0,2.99,139,154,293
1439,146,No math camp,0,3.56,150,168,318
1440,136,No math camp,0,4,150,170,320
1441,139,Math camp,1,2.69,141,146,287
1442,135,No math camp,0,3.24,145,170,315
1443,142,No math camp,0,3.08,143,158,301
1444,135,No math camp,0,2.93,147,158,305
1445,122,No math camp,0,3.07,145,158,303
1446,136,No math camp,0,2.59,147,147,294
1447,136,Math camp,1,2.45,140,158,298
1448,143,Math camp,1,2.4,145,152,297
1449,143,No math camp,0,2.45,154,160,314
1450,141,Math camp,1,2.76,143,157,300
1451,139,Math camp,1,2.63,142,159,301
1452,138,No math camp,0,2.59,146,151,297
1453,128,No math camp,0,2.41,146,149,295
1454,138,No math camp,0,2.82,147,161,308
1455,160,Math camp,1,4,155,170,325
1456,138,No math camp,0,3.33,147,170,317
1457,139,No math camp,0,2.99,148,165,313
1458,137,No math camp,0,2.6,147,154,301
1459,150,No math camp,0,3.59,151,168,319
1460,146,Math camp,1,2.67,140,159,299
1461,142,Math camp,1,3.3,142,154,296
1462,144,No math camp,0,3.41,144,167,311
1463,132,Math camp,1,1.71,137,149,286
1464,150,Math camp,1,3.51,147,165,312
1465,146,Math camp,1,2.96,150,161,311
1466,144,No math camp,0,3.28,145,166,311
1467,135,No math camp,0,3.08,146,160,306
1468,147,Math camp,1,3.3,148,165,313
1469,143,Math camp,1,2.72,140,152,292
1470,137,No math camp,0,3.32,143,164,307
1471,145,No math camp,0,2.75,149,151,300
1472,142,No math camp,0,3.09,146,147,293
1473,137,No math camp,0,2.74,141,156,297
1474,143,No math camp,0,3.78,152,170,322
1475,146,No math camp,0,3.36,153,170,323
1476,145,Math camp,1,2.96,140,165,305
1477,140,Math camp,1,2.54,143,150,293
1478,129,No math camp,0,3.23,148,163,311
1479,152,Math camp,1,2.98,142,164,306
1480,149,Math camp,1,2.36,139,154,293
1481,145,No math camp,0,3.19,139,164,303
1482,137,No math camp,0,3.25,149,160,309
1483,145,Math camp,1,3.32,148,163,311
1484,142,Math camp,1,2.45,141,149,290
1485,138,No math camp,0,3.66,150,164,314
1486,135,No math camp,0,2.86,146,156,302
1487,134,No math camp,0,3.09,143,158,301
1488,151,Math camp,1,2.96,144,157,301
1489,138,No math camp,0,2.71,144,156,300
1490,140,No math camp,0,3.23,147,169,316
1491,140,Math camp,1,2.26,135,140,275
1492,141,No math camp,0,3.56,141,162,303
1493,136,No math camp,0,3.32,153,169,322
1494,141,Math camp,1,2.37,142,143,285
1495,142,Math camp,1,2.98,147,161,308
1496,152,Math camp,1,2.32,142,144,286
1497,135,Math camp,1,1.78,139,146,285
1498,140,Math camp,1,2.89,144,162,306
1499,142,Math camp,1,2.47,138,159,297
1500,149,Math camp,1,2.95,142,167,309
1501,141,No math camp,0,3.33,141,170,311
1502,138,No math camp,0,3.65,153,169,322
1503,139,No math camp,0,3.24,148,160,308
1504,140,No math camp,0,3.39,148,165,313
1505,136,No math camp,0,2.64,145,151,296
1506,142,No math camp,0,3.16,148,163,311
1507,145,No math camp,0,3.53,145,170,315
1508,138,No math camp,0,3.62,152,169,321
1509,144,No math camp,0,4,151,170,321
1510,138,Math camp,1,3.07,144,154,298
1511,136,No math camp,0,2.8,146,154,300
1512,150,Math camp,1,2.84,148,156,304
1513,132,No math camp,0,2.45,140,157,297
1514,139,Math camp,1,2.56,141,155,296
1515,136,No math camp,0,2.98,146,165,311
1516,157,No math camp,0,3.25,156,168,324
1517,128,No math camp,0,2.45,132,161,293
1518,154,Math camp,1,2.82,143,164,307
1519,141,Math camp,1,2.01,141,151,292
1520,146,No math camp,0,3.68,150,158,308
1521,144,Math camp,1,3.42,149,170,319
1522,149,Math camp,1,3.31,146,170,316
1523,140,Math camp,1,2.61,140,149,289
1524,141,No math camp,0,3.66,144,170,314
1525,153,Math camp,1,3.14,146,170,316
1526,138,No math camp,0,3.1,147,160,307
1527,136,No math camp,0,3.91,148,170,318
1528,132,No math camp,0,3.39,147,159,306
1529,146,Math camp,1,2.93,142,167,309
1530,144,Math camp,1,2.76,151,145,296
1531,144,No math camp,0,3.73,149,170,319
1532,132,Math camp,1,2.43,140,152,292
1533,137,No math camp,0,3.51,146,167,313
1534,135,Math camp,1,2.05,133,141,274
1535,148,Math camp,1,2.86,143,164,307
1536,136,No math camp,0,3.53,151,170,321
1537,139,No math camp,0,3.7,145,170,315
1538,133,No math camp,0,2.95,145,159,304
1539,135,No math camp,0,2.45,147,157,304
1540,138,No math camp,0,3.58,148,169,317
1541,156,Math camp,1,2.7,150,156,306
1542,132,No math camp,0,2.85,146,157,303
1543,151,Math camp,1,3,149,170,319
1544,135,No math camp,0,3.25,144,170,314
1545,144,No math camp,0,3.33,153,170,323
1546,140,Math camp,1,2.33,144,149,293
1547,144,No math camp,0,3.28,150,162,312
1548,150,Math camp,1,2.74,151,157,308
1549,148,Math camp,1,2.81,144,147,291
1550,143,No math camp,0,4,152,170,322
1551,133,No math camp,0,2.51,150,137,287
1552,149,Math camp,1,2.39,144,158,302
1553,130,No math camp,0,3.45,146,170,316
1554,130,No math camp,0,3.08,152,165,317
1555,146,Math camp,1,2.84,142,163,305
1556,132,Math camp,1,2.15,137,153,290
1557,156,Math camp,1,3.55,157,161,318
1558,150,Math camp,1,2.81,143,167,310
1559,147,No math camp,0,2.98,143,170,313
1560,139,Math camp,1,2.77,143,154,297
1561,141,No math camp,0,3,148,160,308
1562,138,No math camp,0,3.66,147,162,309
1563,143,No math camp,0,2.96,150,159,309
1564,157,Math camp,1,3.11,153,169,322
1565,144,No math camp,0,3.45,150,153,303
1566,135,No math camp,0,3.02,148,158,306
1567,132,No math camp,0,2.7,135,150,285
1568,139,Math camp,1,2.91,143,146,289
1569,153,Math camp,1,2.82,137,161,298
1570,143,No math camp,0,3.29,145,164,309
1571,147,No math camp,0,3.82,151,170,321
1572,151,Math camp,1,2.67,144,158,302
1573,133,No math camp,0,3.44,149,163,312
1574,139,No math camp,0,2.52,146,144,290
1575,143,No math camp,0,3.42,148,167,315
1576,131,Math camp,1,2.4,134,151,285
1577,141,No math camp,0,3.19,145,167,312
1578,142,No math camp,0,3.3,146,165,311
1579,136,No math camp,0,3.44,148,160,308
1580,132,No math camp,0,3,142,155,297
1581,150,Math camp,1,3.23,143,164,307
1582,133,No math camp,0,3.11,142,153,295
1583,134,Math camp,1,2.71,145,145,290
1584,137,No math camp,0,2.92,151,159,310
1585,149,Math camp,1,3.71,148,170,318
1586,154,Math camp,1,2.99,144,161,305
1587,139,Math camp,1,1.96,140,146,286
1588,134,No math camp,0,3.62,152,167,319
1589,141,No math camp,0,2.92,149,157,306
1590,137,No math camp,0,3.09,153,152,305
1591,143,No math camp,0,3.62,143,168,311
1592,143,No math camp,0,3.23,143,168,311
1593,136,No math camp,0,3.21,144,164,308
1594,135,Math camp,1,2.29,138,151,289
1595,139,No math camp,0,2.99,148,170,318
1596,148,No math camp,0,3.19,151,166,317
1597,151,Math camp,1,2.78,141,166,307
1598,129,No math camp,0,3.87,144,170,314
1599,147,Math camp,1,2.92,145,165,310
1600,128,Math camp,1,2.65,141,138,279
1601,147,No math camp,0,3.8,148,170,318
1602,142,No math camp,0,4,153,170,323
1603,139,No math camp,0,3.59,147,170,317
1604,145,Math camp,1,2.48,142,162,304
1605,142,No math camp,0,3.75,150,170,320
1606,138,No math camp,0,2.12,145,146,291
1607,141,Math camp,1,2.62,143,159,302
1608,145,No math camp,0,4,155,170,325
1609,149,No math camp,0,3.85,151,169,320
1610,144,Math camp,1,3.24,150,162,312
1611,142,Math camp,1,2.94,143,160,303
1612,143,Math camp,1,1.79,146,142,288
1613,128,No math camp,0,3.1,139,165,304
1614,147,Math camp,1,3.54,155,170,325
1615,145,No math camp,0,3.09,145,157,302
1616,152,Math camp,1,2.97,158,158,316
1617,146,Math camp,1,2.87,141,170,311
1618,129,No math camp,0,2.36,138,149,287
1619,146,No math camp,0,3.44,150,169,319
1620,151,Math camp,1,2.33,145,146,291
1621,134,No math camp,0,3.13,146,162,308
1622,137,Math camp,1,1.93,136,148,284
1623,141,Math camp,1,2.25,145,148,293
1624,144,Math camp,1,2.91,144,161,305
1625,129,No math camp,0,1.94,138,139,277
1626,149,Math camp,1,2.81,140,156,296
1627,141,No math camp,0,4,152,170,322
1628,147,Math camp,1,2.85,143,162,305
1629,134,No math camp,0,3.4,149,163,312
1630,143,Math camp,1,2.31,143,145,288
1631,128,No math camp,0,2.8,151,145,296
1632,127,Math camp,1,2.63,140,147,287
1633,127,No math camp,0,2.98,143,145,288
1634,144,Math camp,1,3.29,154,156,310
1635,142,No math camp,0,3.6,151,161,312
1636,134,No math camp,0,3,149,150,299
1637,148,Math camp,1,2.66,141,154,295
1638,142,Math camp,1,2.94,141,156,297
1639,137,No math camp,0,3.11,141,164,305
1640,121,No math camp,0,2.46,145,145,290
1641,131,No math camp,0,2.39,144,151,295
1642,142,Math camp,1,2.93,139,154,293
1643,137,No math camp,0,3.24,145,163,308
1644,142,Math camp,1,3.36,149,161,310
1645,133,No math camp,0,2.87,143,167,310
1646,130,Math camp,1,1.74,138,146,284
1647,136,No math camp,0,3.1,139,170,309
1648,149,No math camp,0,3.17,145,170,315
1649,147,Math camp,1,2.87,142,150,292
1650,141,No math camp,0,3.55,154,170,324
1651,153,Math camp,1,2.87,145,154,299
1652,147,No math camp,0,3.27,150,170,320
1653,141,Math camp,1,2.82,142,151,293
1654,142,No math camp,0,2.78,155,151,306
1655,121,No math camp,0,2.72,146,157,303
1656,146,Math camp,1,2.69,143,154,297
1657,144,Math camp,1,2.73,150,154,304
1658,147,Math camp,1,3.38,155,163,318
1659,139,No math camp,0,3.65,149,170,319
1660,140,No math camp,0,3.81,158,160,318
1661,135,No math camp,0,3.15,137,169,306
1662,134,Math camp,1,2.56,141,154,295
1663,150,Math camp,1,3.69,151,170,321
1664,155,Math camp,1,3.36,150,170,320
1665,137,No math camp,0,2.94,144,156,300
1666,132,No math camp,0,2.92,149,147,296
1667,139,No math camp,0,2.91,149,155,304
1668,135,No math camp,0,2.87,142,163,305
1669,156,Math camp,1,3.31,150,160,310
1670,144,Math camp,1,3.32,143,154,297
1671,148,No math camp,0,3.62,148,168,316
1672,134,Math camp,1,2.68,140,159,299
1673,138,No math camp,0,2.7,147,157,304
1674,143,Math camp,1,3.03,142,161,303
1675,139,Math camp,1,2.24,140,148,288
1676,139,No math camp,0,2.83,146,155,301
1677,141,No math camp,0,3.84,147,164,311
1678,140,No math camp,0,3.45,148,170,318
1679,145,Math camp,1,3.18,146,161,307
1680,141,Math camp,1,2.47,137,155,292
1681,138,No math camp,0,2.63,148,153,301
1682,142,No math camp,0,3.91,146,170,316
1683,150,Math camp,1,2.82,145,164,309
1684,133,No math camp,0,3.84,148,170,318
1685,142,No math camp,0,3.19,148,168,316
1686,128,No math camp,0,2.29,142,149,291
1687,138,No math camp,0,2.66,145,150,295
1688,132,No math camp,0,3.08,148,153,301
1689,144,Math camp,1,2.5,148,160,308
1690,143,No math camp,0,3.18,146,162,308
1691,142,No math camp,0,3.63,151,158,309
1692,133,Math camp,1,2.07,144,146,290
1693,148,Math camp,1,2.79,145,159,304
1694,138,No math camp,0,4,151,168,319
1695,142,No math camp,0,3.97,152,170,322
1696,145,No math camp,0,3.38,145,165,310
1697,145,No math camp,0,3.03,151,164,315
1698,134,Math camp,1,2.87,141,157,298
1699,146,Math camp,1,3.35,154,163,317
1700,138,No math camp,0,3.05,148,154,302
1701,141,No math camp,0,3.21,147,163,310
1702,138,No math camp,0,2.78,141,167,308
1703,145,No math camp,0,3.85,150,170,320
1704,142,No math camp,0,3.62,151,169,320
1705,141,Math camp,1,2.49,137,156,293
1706,137,No math camp,0,3.5,146,167,313
1707,133,No math camp,0,3.41,139,163,302
1708,135,No math camp,0,3.86,145,170,315
1709,131,No math camp,0,2.38,145,154,299
1710,134,No math camp,0,2.4,142,159,301
1711,137,No math camp,0,2.96,150,160,310
1712,138,Math camp,1,2.32,135,150,285
1713,134,No math camp,0,3.28,152,156,308
1714,140,No math camp,0,3.58,147,162,309
1715,134,No math camp,0,2.34,143,139,282
1716,141,Math camp,1,3.5,143,167,310
1717,147,Math camp,1,3.08,145,155,300
1718,131,No math camp,0,3.01,143,164,307
1719,137,No math camp,0,2.94,145,164,309
1720,134,Math camp,1,2.57,140,152,292
1721,132,No math camp,0,2.77,139,162,301
1722,133,No math camp,0,3.61,153,167,320
1723,142,No math camp,0,3.38,140,168,308
1724,143,No math camp,0,3.52,145,166,311
1725,141,No math camp,0,3.26,146,158,304
1726,146,Math camp,1,3.64,152,162,314
1727,139,Math camp,1,3.24,148,160,308
1728,141,Math camp,1,2.31,143,141,284
1729,155,Math camp,1,4,157,170,327
1730,134,No math camp,0,3.49,146,166,312
1731,145,Math camp,1,2.83,143,160,303
1732,150,Math camp,1,3.57,155,170,325
1733,130,No math camp,0,2.48,137,138,275
1734,132,No math camp,0,3.5,152,165,317
1735,133,No math camp,0,2.23,145,146,291
1736,138,No math camp,0,3.28,141,168,309
1737,139,No math camp,0,3.66,157,166,323
1738,131,No math camp,0,2.98,137,170,307
1739,143,No math camp,0,3.96,151,170,321
1740,143,No math camp,0,3.62,148,170,318
1741,140,Math camp,1,1.71,136,148,284
1742,134,No math camp,0,3.45,150,165,315
1743,144,No math camp,0,3.62,145,163,308
1744,134,No math camp,0,3.13,140,166,306
1745,136,No math camp,0,3.35,147,160,307
1746,155,Math camp,1,3.65,151,170,321
1747,135,No math camp,0,2.85,138,164,302
1748,144,Math camp,1,2.53,136,157,293
1749,147,Math camp,1,2.59,146,153,299
1750,140,Math camp,1,2.16,137,158,295
1751,138,No math camp,0,3.24,140,170,310
1752,144,Math camp,1,2.73,144,153,297
1753,141,No math camp,0,2.65,148,151,299
1754,138,Math camp,1,2.51,144,143,287
1755,141,No math camp,0,3.21,143,170,313
1756,145,Math camp,1,2.39,144,154,298
1757,142,Math camp,1,3.03,142,163,305
1758,142,Math camp,1,2.75,141,150,291
1759,139,No math camp,0,2.78,144,157,301
1760,136,No math camp,0,3.81,149,170,319
1761,139,No math camp,0,3,142,167,309
1762,143,No math camp,0,2.46,147,151,298
1763,154,Math camp,1,2.14,141,162,303
1764,152,Math camp,1,3.57,148,170,318
1765,142,Math camp,1,2.11,136,142,278
1766,125,No math camp,0,3.08,136,162,298
1767,151,Math camp,1,2.56,144,151,295
1768,144,No math camp,0,4,153,170,323
1769,143,No math camp,0,3.29,148,164,312
1770,145,No math camp,0,3.44,148,170,318
1771,143,Math camp,1,2.51,134,148,282
1772,146,Math camp,1,2.2,144,148,292
1773,136,Math camp,1,3,144,168,312
1774,147,Math camp,1,2.28,142,154,296
1775,144,Math camp,1,2.74,139,156,295
1776,139,No math camp,0,3.37,143,170,313
1777,137,No math camp,0,2.8,150,164,314
1778,142,Math camp,1,2.51,139,154,293
1779,142,Math camp,1,2.87,147,155,302
1780,141,Math camp,1,2.18,144,148,292
1781,140,No math camp,0,3.21,148,162,310
1782,146,Math camp,1,2.94,145,164,309
1783,138,Math camp,1,2.36,141,149,290
1784,138,No math camp,0,3.23,143,159,302
1785,145,Math camp,1,2.86,143,155,298
1786,138,No math camp,0,3.84,148,170,318
1787,157,Math camp,1,3.39,156,170,326
1788,135,No math camp,0,3.01,141,166,307
1789,141,Math camp,1,2.83,145,160,305
1790,142,Math camp,1,2.58,140,152,292
1791,131,No math camp,0,2.83,146,157,303
1792,144,No math camp,0,3.6,155,166,321
1793,144,No math camp,0,3.01,145,168,313
1794,139,Math camp,1,2.42,140,139,279
1795,143,Math camp,1,2.54,140,151,291
1796,136,Math camp,1,2.6,134,158,292
1797,140,No math camp,0,3.09,147,152,299
1798,149,Math camp,1,2.46,141,159,300
1799,150,No math camp,0,3.36,150,170,320
1800,142,No math camp,0,3.26,147,167,314
1801,144,No math camp,0,3.59,149,170,319
1802,130,Math camp,1,2.56,140,138,278
1803,139,No math camp,0,3.34,154,168,322
1804,134,No math camp,0,3.23,146,167,313
1805,140,Math camp,1,2.69,142,155,297
1806,141,Math camp,1,2.69,148,159,307
1807,147,No math camp,0,4,156,170,326
1808,135,No math camp,0,2.75,147,155,302
1809,136,No math camp,0,3.77,143,170,313
1810,142,No math camp,0,3.4,152,170,322
1811,144,No math camp,0,3.13,152,167,319
1812,134,No math camp,0,2.99,147,149,296
1813,136,No math camp,0,2.72,144,160,304
1814,134,No math camp,0,2.97,147,155,302
1815,136,No math camp,0,2.44,133,166,299
1816,134,No math camp,0,2.67,141,160,301
1817,149,Math camp,1,2.83,147,159,306
1818,142,Math camp,1,2.16,141,140,281
1819,140,Math camp,1,2.3,140,132,272
1820,143,Math camp,1,2.77,142,155,297
1821,140,No math camp,0,3.88,146,170,316
1822,140,No math camp,0,3.45,154,163,317
1823,141,No math camp,0,3.26,154,158,312
1824,142,No math camp,0,2.86,141,158,299
1825,143,No math camp,0,3.93,157,169,326
1826,136,No math camp,0,2.99,145,156,301
1827,142,Math camp,1,2.4,137,155,292
1828,158,Math camp,1,3.48,153,163,316
1829,129,No math camp,0,2.28,145,151,296
1830,142,No math camp,0,2.58,145,170,315
1831,129,No math camp,0,3.02,142,161,303
1832,130,Math camp,1,2.21,139,151,290
1833,132,No math camp,0,3,152,161,313
1834,134,No math camp,0,3.15,143,167,310
1835,140,No math camp,0,2.66,146,159,305
1836,128,No math camp,0,1.86,136,141,277
1837,137,No math camp,0,2.19,137,160,297
1838,145,Math camp,1,2.38,147,155,302
1839,142,No math camp,0,3.09,144,170,314
1840,144,No math camp,0,2.55,145,149,294
1841,138,No math camp,0,3.03,149,163,312
1842,141,Math camp,1,2.5,144,144,288
1843,145,No math camp,0,4,152,170,322
1844,137,No math camp,0,2.43,145,152,297
1845,151,No math camp,0,3.29,150,170,320
1846,139,Math camp,1,2.27,139,146,285
1847,143,No math camp,0,2.37,148,152,300
1848,136,No math camp,0,2.99,146,151,297
1849,148,Math camp,1,2.99,143,156,299
1850,127,Math camp,1,1.82,133,141,274
1851,136,Math camp,1,2.71,137,146,283
1852,141,No math camp,0,3.38,146,170,316
1853,140,Math camp,1,2.51,139,154,293
1854,137,Math camp,1,2.41,141,164,305
1855,143,Math camp,1,2.97,137,165,302
1856,160,Math camp,1,3.54,150,170,320
1857,134,No math camp,0,3.28,144,162,306
1858,142,No math camp,0,3.26,151,170,321
1859,146,No math camp,0,3.15,148,165,313
1860,128,No math camp,0,3.41,141,165,306
1861,146,Math camp,1,3.56,148,169,317
1862,135,No math camp,0,2.91,151,156,307
1863,138,Math camp,1,2.52,145,149,294
1864,130,No math camp,0,2.83,140,165,305
1865,138,Math camp,1,2.31,137,155,292
1866,132,No math camp,0,3.12,148,162,310
1867,144,Math camp,1,2.48,142,155,297
1868,148,Math camp,1,2.74,146,156,302
1869,131,No math camp,0,3.14,143,157,300
1870,143,No math camp,0,2.8,148,155,303
1871,154,Math camp,1,3.99,155,170,325
1872,130,No math camp,0,2.63,142,169,311
1873,146,Math camp,1,2.34,139,148,287
1874,142,No math camp,0,3.75,154,168,322
1875,132,No math camp,0,3.33,144,161,305
1876,143,Math camp,1,2.71,138,162,300
1877,142,Math camp,1,2.89,144,158,302
1878,141,Math camp,1,2.23,140,141,281
1879,146,Math camp,1,3.11,145,170,315
1880,139,Math camp,1,2.3,138,147,285
1881,132,Math camp,1,2.49,142,154,296
1882,140,Math camp,1,2.5,144,155,299
1883,140,No math camp,0,2.94,140,167,307
1884,137,Math camp,1,2.13,136,150,286
1885,142,Math camp,1,2.69,143,155,298
1886,137,No math camp,0,3.2,145,160,305
1887,146,Math camp,1,3.32,147,170,317
1888,140,Math camp,1,2.67,141,152,293
1889,138,No math camp,0,2.93,150,160,310
1890,136,No math camp,0,3,143,164,307
1891,147,Math camp,1,2.85,148,148,296
1892,128,No math camp,0,2.11,134,153,287
1893,149,No math camp,0,3.49,158,163,321
1894,138,Math camp,1,2.34,145,151,296
1895,138,No math camp,0,3.99,144,170,314
1896,141,Math camp,1,2.68,141,153,294
1897,139,No math camp,0,3.4,149,168,317
1898,139,No math camp,0,3.32,138,170,308
1899,132,No math camp,0,2.22,143,141,284
1900,136,No math camp,0,2.96,147,162,309
1901,135,No math camp,0,2.83,137,157,294
1902,131,No math camp,0,3.44,144,170,314
1903,150,Math camp,1,2.98,145,161,306
1904,144,Math camp,1,3.15,143,157,300
1905,129,No math camp,0,2.61,144,149,293
1906,133,No math camp,0,3.5,148,157,305
1907,145,Math camp,1,2.79,140,156,296
1908,135,No math camp,0,2.55,145,158,303
1909,146,Math camp,1,2.42,151,150,301
1910,152,Math camp,1,2.61,145,151,296
1911,144,Math camp,1,2.87,144,170,314
1912,143,Math camp,1,2.26,142,157,299
1913,143,No math camp,0,3.41,152,166,318
1914,137,No math camp,0,3.5,144,170,314
1915,149,Math camp,1,2.66,141,150,291
1916,144,Math camp,1,2.69,140,151,291
1917,136,No math camp,0,3.61,148,166,314
1918,136,No math camp,0,3.78,145,170,315
1919,139,No math camp,0,3.12,151,150,301
1920,143,No math camp,0,3.27,148,161,309
1921,149,No math camp,0,3.27,148,167,315
1922,135,No math camp,0,3.2,139,168,307
1923,143,No math camp,0,3.77,155,170,325
1924,147,Math camp,1,2.96,145,163,308
1925,136,Math camp,1,2.38,139,140,279
1926,140,No math camp,0,3.46,151,163,314
1927,139,No math camp,0,3.3,145,169,314
1928,139,Math camp,1,2.25,137,151,288
1929,143,Math camp,1,2.98,139,160,299
1930,126,No math camp,0,2.45,140,155,295
1931,144,Math camp,1,3.53,146,168,314
1932,145,Math camp,1,2.61,143,161,304
1933,137,No math camp,0,3.06,155,152,307
1934,142,No math camp,0,3.78,152,170,322
1935,127,No math camp,0,2.57,145,151,296
1936,136,Math camp,1,2.81,143,156,299
1937,138,No math camp,0,3.79,143,170,313
1938,143,Math camp,1,2.66,142,157,299
1939,148,Math camp,1,3.66,148,170,318
1940,139,No math camp,0,3.41,146,162,308
1941,143,No math camp,0,2.62,148,154,302
1942,130,No math camp,0,3.4,149,167,316
1943,143,No math camp,0,2.87,150,165,315
1944,130,No math camp,0,3.14,142,168,310
1945,146,No math camp,0,3.08,144,165,309
1946,139,No math camp,0,3.21,147,163,310
1947,138,No math camp,0,3.49,149,167,316
1948,144,No math camp,0,3.42,146,168,314
1949,133,Math camp,1,2.68,145,152,297
1950,145,No math camp,0,3.41,142,170,312
1951,140,No math camp,0,3,154,149,303
1952,144,No math camp,0,3.61,145,160,305
1953,147,Math camp,1,3.42,142,170,312
1954,139,Math camp,1,2.73,138,152,290
1955,141,No math camp,0,3.29,148,162,310
1956,136,No math camp,0,3.06,147,162,309
1957,144,Math camp,1,3.19,136,169,305
1958,140,No math camp,0,3.29,149,159,308
1959,143,Math camp,1,2.89,138,167,305
1960,140,No math camp,0,3.2,150,170,320
1961,123,No math camp,0,2.77,144,167,311
1962,131,No math camp,0,2.98,147,158,305
1963,127,No math camp,0,3.03,145,148,293
1964,135,Math camp,1,2.94,140,156,296
1965,145,Math camp,1,2.77,140,153,293
1966,146,Math camp,1,2.66,147,153,300
1967,141,Math camp,1,2.58,148,149,297
1968,129,No math camp,0,2.16,136,146,282
1969,156,Math camp,1,4,152,170,322
1970,137,No math camp,0,3.07,143,170,313
1971,145,No math camp,0,3.35,147,162,309
1972,145,Math camp,1,3.82,155,170,325
1973,136,No math camp,0,3.21,139,170,309
1974,149,Math camp,1,2.79,143,157,300
1975,149,No math camp,0,3.61,153,170,323
1976,138,Math camp,1,2.09,139,131,270
1977,156,Math camp,1,3.29,148,161,309
1978,144,Math camp,1,2.72,142,153,295
1979,126,No math camp,0,3.08,141,156,297
1980,165,Math camp,1,3.82,152,170,322
1981,132,No math camp,0,3.11,143,162,305
1982,136,No math camp,0,3.48,151,170,321
1983,134,No math camp,0,3.21,139,161,300
1984,142,Math camp,1,2.9,139,155,294
1985,147,No math camp,0,3.04,146,161,307
1986,141,No math camp,0,4,154,170,324
1987,147,Math camp,1,2.69,145,150,295
1988,136,No math camp,0,3.56,150,167,317
1989,134,No math camp,0,2.31,138,146,284
1990,148,Math camp,1,2.53,139,157,296
1991,145,No math camp,0,3.45,145,168,313
1992,133,No math camp,0,3.33,145,169,314
1993,137,No math camp,0,3.06,145,159,304
1994,131,No math camp,0,3.68,145,170,315
1995,146,Math camp,1,2.37,135,154,289
1996,144,Math camp,1,2.86,142,156,298
1997,132,Math camp,1,2.55,139,158,297
1998,142,Math camp,1,2.76,141,152,293
1999,143,No math camp,0,3.77,153,170,323
2000,157,Math camp,1,3.67,152,170,322
